//MAP CONVERTED BY dmm2tgm.py THIS HEADER COMMENT PREVENTS RECONVERSION, DO NOT REMOVE
"o" = (
/turf/open/floor/plating,
/area/template_noop)
"A" = (
/obj/item/airlock_painter,
/obj/structure/closet,
/turf/open/floor/plating,
/area/template_noop)
"Q" = (
/obj/item/paper/crumpled,
/turf/open/floor/plating,
/area/template_noop)

(1,1,1) = {"
o
o
o
"}
(2,1,1) = {"
o
A
o
"}
(3,1,1) = {"
Q
o
o
"}
