//MAP CONVERTED BY dmm2tgm.py THIS HEADER COMMENT PREVENTS RECONVERSION, DO NOT REMOVE
"ag" = (
/obj/structure/flora/ausbushes/fullgrass,
/turf/open/floor/grass/grass2,
/area/hilbertshotel)
"aO" = (
/obj/structure/flora/ausbushes/brflowers,
/turf/open/floor/grass/grass0,
/area/hilbertshotel)
"aP" = (
/obj/structure/bed/double,
/turf/open/floor/spooktime/beach,
/area/hilbertshotel)
"br" = (
/obj/structure/flora/tree/spookylog{
	pixel_x = 3;
	pixel_y = -2
	},
/turf/open/floor/grass/grass2,
/area/hilbertshotel)
"bH" = (
/obj/structure/flora/rock/pile,
/turf/open/floor/grass,
/area/hilbertshotel)
"cC" = (
/obj/structure/flora/ausbushes/fernybush,
/turf/open/floor/grass,
/area/hilbertshotel)
"cI" = (
/turf/open/floor/spooktime/beach,
/area/hilbertshotel)
"cN" = (
/obj/structure/spacevine,
/obj/structure/flora/ausbushes/brflowers,
/obj/structure/flora/ausbushes/ppflowers,
/obj/structure/flora/ausbushes/fullgrass,
/obj/structure/window/reinforced/tinted/frosted{
	dir = 8;
	invisibility = 1
	},
/turf/open/floor/spooktime/beach,
/area/hilbertshotel)
"dl" = (
/obj/machinery/light/floor{
	light_power = 20;
	light_range = 5;
	invisibility = 1
	},
/turf/open/floor/spooktime/beach/coasts/coastNW,
/area/hilbertshotel)
"eS" = (
/obj/structure/flora/ausbushes/grassybush,
/turf/open/floor/grass,
/area/hilbertshotel)
"gX" = (
/obj/machinery/light/floor{
	light_power = 20;
	light_range = 5
	},
/obj/structure/flora/ausbushes/grassybush,
/turf/open/floor/grass,
/area/hilbertshotel)
"hA" = (
/turf/open/floor/spooktime/beach/coasts/coastNE,
/area/hilbertshotel)
"hD" = (
/turf/open/floor/spooktime/cobble/sideW,
/area/hilbertshotel)
"iB" = (
/obj/structure/flora/ausbushes/lavendergrass,
/obj/structure/flora/ausbushes/brflowers,
/turf/open/floor/grass/grass2,
/area/hilbertshotel)
"iJ" = (
/obj/structure/flora/ausbushes/grassybush,
/obj/machinery/light/floor{
	light_power = 20;
	light_range = 5
	},
/turf/open/floor/grass/grass0,
/area/hilbertshotel)
"jw" = (
/obj/machinery/telecomms/relay/preset/auto,
/turf/open/floor/catwalk_floor,
/area/hilbertshotel)
"kf" = (
/obj/structure/spacevine,
/turf/closed/indestructible/rock,
/area/hilbertshotel)
"kS" = (
/obj/structure/flora/ausbushes/fullgrass,
/obj/structure/flora/tree/jungle{
	pixel_x = -72;
	pixel_y = -29
	},
/turf/open/floor/grass/grass0,
/area/hilbertshotel)
"lh" = (
/turf/open/floor/spooktime/beach/coasts/coastW,
/area/hilbertshotel)
"lC" = (
/obj/structure/flora/biolumi/mine,
/turf/open/floor/grass/grass1,
/area/hilbertshotel)
"lT" = (
/obj/effect/overlay/palmtree_l,
/turf/open/floor/spooktime/beach/coasts/innerE,
/area/hilbertshotel)
"mz" = (
/obj/structure/flora/rock,
/obj/structure/flora/rock,
/turf/open/floor/spooktime/beach,
/area/hilbertshotel)
"nb" = (
/obj/structure/chair/pew/right,
/turf/open/floor/grass,
/area/hilbertshotel)
"oF" = (
/obj/structure/flora/junglebush/c,
/turf/open/floor/grass/grass2,
/area/hilbertshotel)
"pd" = (
/turf/open/floor/spooktime/cobble/sideN,
/area/hilbertshotel)
"pM" = (
/obj/structure/chair/pew,
/turf/open/floor/grass,
/area/hilbertshotel)
"rE" = (
/obj/structure/flora/ausbushes/grassybush,
/obj/machinery/light/floor{
	light_power = 20;
	light_range = 5
	},
/turf/open/floor/spooktime/beach,
/area/hilbertshotel)
"sx" = (
/obj/structure/flora/ausbushes/fullgrass,
/turf/open/floor/grass,
/area/hilbertshotel)
"sS" = (
/obj/structure/flora/ausbushes/lavendergrass,
/turf/open/floor/grass/grass1,
/area/hilbertshotel)
"tg" = (
/obj/structure/flora/tree/palm,
/turf/open/floor/spooktime/beach,
/area/hilbertshotel)
"tX" = (
/turf/open/floor/spooktime/cobble/cornerNE,
/area/hilbertshotel)
"uz" = (
/obj/item/toy/cards/deck,
/turf/open/floor/carpet/blackred,
/area/hilbertshotel)
"uD" = (
/obj/structure/chair/pew{
	dir = 8
	},
/turf/open/floor/grass/grass0,
/area/hilbertshotel)
"we" = (
/turf/open/floor/spooktime/cobble/sideE,
/area/hilbertshotel)
"xv" = (
/obj/structure/flora/ausbushes/brflowers,
/turf/open/floor/grass/grass1,
/area/hilbertshotel)
"xJ" = (
/obj/structure/flora/ausbushes/fullgrass,
/obj/structure/flora/ausbushes/brflowers,
/turf/open/floor/grass/grass2,
/area/hilbertshotel)
"xQ" = (
/obj/structure/flora/ausbushes/fullgrass,
/turf/open/floor/spooktime/beach,
/area/hilbertshotel)
"yr" = (
/turf/closed/indestructible/rock,
/area/hilbertshotel)
"yD" = (
/obj/structure/flora/ausbushes/fullgrass,
/turf/open/floor/spooktime/beach/coasts/innerE,
/area/hilbertshotel)
"yU" = (
/turf/open/floor/spooktime/cobble/cornerNW,
/area/hilbertshotel)
"yV" = (
/obj/machinery/vending/kink{
	custom_premium_price = 0;
	custom_price = 0
	},
/turf/open/floor/spooktime/beach,
/area/hilbertshotel)
"Ah" = (
/turf/open/floor/plating/beach/water,
/area/hilbertshotel)
"BZ" = (
/turf/open/floor/spooktime/beach/coasts/coastN,
/area/hilbertshotel)
"CC" = (
/obj/structure/flora/ausbushes/sunnybush,
/turf/open/floor/grass/grass2,
/area/hilbertshotel)
"CR" = (
/turf/open/floor/grass/grass2,
/area/hilbertshotel)
"Dc" = (
/obj/structure/chair/pew/left,
/turf/open/floor/grass,
/area/hilbertshotel)
"De" = (
/obj/effect/overlay/palmtree_r,
/turf/open/floor/spooktime/beach,
/area/hilbertshotel)
"Dl" = (
/turf/closed/indestructible/hoteldoor{
	icon_state = "door_closed";
	icon = 'icons/obj/doors/puzzledoor/default.dmi'
	},
/area/hilbertshotel)
"Dx" = (
/obj/structure/fluff/beach_umbrella/science{
	pixel_x = 7;
	pixel_y = 11
	},
/obj/item/reagent_containers/rag/towel/random{
	pixel_x = -8;
	pixel_y = -9
	},
/turf/open/floor/spooktime/beach,
/area/hilbertshotel)
"DA" = (
/turf/open/floor/spooktime/cobble/cornerSE,
/area/hilbertshotel)
"Ew" = (
/obj/structure/flora/ausbushes/fullgrass,
/obj/structure/flora/tree/spookybranch,
/turf/open/floor/grass/grass2,
/area/hilbertshotel)
"Ex" = (
/turf/open/floor/grass,
/area/hilbertshotel)
"Fs" = (
/obj/machinery/light/floor{
	light_power = 20;
	light_range = 5
	},
/obj/structure/flora/rock,
/turf/open/floor/spooktime/beach/coasts/coastN,
/area/hilbertshotel)
"Fu" = (
/obj/structure/flora/ausbushes/lavendergrass,
/turf/open/floor/grass,
/area/hilbertshotel)
"GU" = (
/obj/structure/flora/ausbushes/grassybush,
/obj/machinery/light/floor{
	light_power = 20;
	light_range = 5
	},
/turf/open/floor/grass,
/area/hilbertshotel)
"Hw" = (
/obj/structure/flora/ausbushes/grassybush,
/obj/machinery/light/floor{
	light_power = 20;
	light_range = 5
	},
/turf/open/floor/grass/grass2,
/area/hilbertshotel)
"HM" = (
/obj/structure/flora/tree/jungle,
/turf/open/floor/grass,
/area/hilbertshotel)
"Iy" = (
/obj/item/toy/beach_ball,
/turf/open/floor/plating/beach/water,
/area/hilbertshotel)
"JC" = (
/obj/structure/flora/ausbushes/fullgrass,
/turf/open/floor/grass/grass1,
/area/hilbertshotel)
"Ld" = (
/obj/structure/flora/biolumi/flower,
/turf/open/floor/grass/grass2,
/area/hilbertshotel)
"LH" = (
/obj/structure/flora/ausbushes/fullgrass,
/turf/open/floor/spooktime/beach/coasts/coastW,
/area/hilbertshotel)
"MC" = (
/obj/structure/bonfire,
/obj/item/lighter/gold,
/turf/open/floor/spooktime/cobble,
/area/hilbertshotel)
"Ng" = (
/obj/structure/flora/biolumi/mine,
/turf/open/floor/grass,
/area/hilbertshotel)
"Nl" = (
/obj/machinery/light/floor{
	light_power = 20;
	light_range = 5;
	invisibility = 1
	},
/obj/structure/flora/ausbushes/grassybush,
/turf/open/floor/grass,
/area/hilbertshotel)
"Og" = (
/obj/structure/flora/rock/pile,
/turf/open/floor/grass/grass2,
/area/hilbertshotel)
"Oh" = (
/obj/structure/spacevine,
/obj/structure/flora/ausbushes/brflowers,
/obj/structure/flora/ausbushes/ppflowers,
/obj/structure/flora/ausbushes/fullgrass,
/obj/structure/window/reinforced/tinted/frosted{
	dir = 4;
	invisibility = 1
	},
/turf/open/floor/spooktime/beach,
/area/hilbertshotel)
"Po" = (
/turf/open/floor/grass/grass1,
/area/hilbertshotel)
"Px" = (
/turf/open/indestructible/cobble/side,
/area/hilbertshotel)
"PZ" = (
/obj/item/candle/infinite,
/turf/open/floor/spooktime/beach,
/area/hilbertshotel)
"Qp" = (
/obj/effect/spawner/lootdrop/three_course_meal{
	pixel_y = 9
	},
/obj/effect/spawner/lootdrop/three_course_meal{
	pixel_y = 9
	},
/obj/item/storage/bag/easterbasket{
	pixel_y = 6
	},
/obj/item/reagent_containers/food/drinks/bottle/wine{
	pixel_x = -7
	},
/turf/open/floor/carpet/blackred,
/area/hilbertshotel)
"QO" = (
/obj/structure/chair/pew/left{
	dir = 8
	},
/turf/open/floor/grass,
/area/hilbertshotel)
"RQ" = (
/obj/structure/flora/tree/jungle/small,
/turf/open/floor/grass,
/area/hilbertshotel)
"RW" = (
/obj/structure/flora/ausbushes/grassybush,
/obj/machinery/light/floor{
	light_power = 20;
	light_range = 5
	},
/obj/machinery/light/floor{
	light_power = 20;
	light_range = 5
	},
/turf/open/floor/grass,
/area/hilbertshotel)
"Su" = (
/obj/structure/chair/pew/right{
	dir = 8
	},
/turf/open/floor/grass,
/area/hilbertshotel)
"Sy" = (
/obj/structure/flora/ausbushes/grassybush,
/turf/open/floor/grass/grass2,
/area/hilbertshotel)
"Uq" = (
/turf/open/floor/spooktime/beach/coasts/coastE,
/area/hilbertshotel)
"Vt" = (
/obj/structure/fluff/beach_umbrella/science{
	pixel_x = 1;
	pixel_y = 10
	},
/turf/open/floor/carpet/blackred,
/area/hilbertshotel)
"We" = (
/obj/structure/flora/ausbushes/lavendergrass,
/turf/open/floor/grass/grass0,
/area/hilbertshotel)
"Wx" = (
/turf/open/floor/grass/grass0,
/area/hilbertshotel)
"WD" = (
/turf/open/floor/spooktime/beach/coasts/innerN,
/area/hilbertshotel)
"XA" = (
/obj/item/storage/fancy/heart_box,
/obj/item/paper/fluff/hilbertshotel/welcomeletter,
/turf/open/floor/carpet/blackred,
/area/hilbertshotel)
"Yd" = (
/obj/structure/flora/ausbushes/brflowers,
/turf/open/floor/grass/grass2,
/area/hilbertshotel)
"YF" = (
/turf/open/floor/spooktime/cobble/cornerSW,
/area/hilbertshotel)
"YH" = (
/obj/structure/flora/ausbushes/fullgrass,
/obj/structure/flora/ausbushes/grassybush,
/obj/machinery/light/floor{
	light_power = 20;
	light_range = 5
	},
/turf/open/floor/grass,
/area/hilbertshotel)
"Zs" = (
/obj/structure/flora/biolumi/lamp,
/turf/open/floor/grass,
/area/hilbertshotel)

(1,1,1) = {"
yr
yr
yr
yr
yr
yr
yr
yr
yr
yr
yr
yr
yr
yr
yr
yr
"}
(2,1,1) = {"
yr
cI
rE
cI
cI
cI
Hw
CR
CC
Ld
CR
Nl
cC
Ex
yr
yr
"}
(3,1,1) = {"
yr
yr
mz
Uq
WD
tg
cI
CR
ag
CR
Sy
HM
Ex
CR
gX
yr
"}
(4,1,1) = {"
yr
yr
yr
Ah
hA
WD
Dx
xQ
sx
Ex
Ex
Ld
Qp
XA
Ex
yr
"}
(5,1,1) = {"
yr
yr
yr
Ah
Ah
hA
WD
cI
Yd
sS
Yd
Ex
Vt
uz
Ex
yr
"}
(6,1,1) = {"
yr
aP
cI
kf
Ah
Iy
Fs
cI
Yd
oF
iB
Yd
Ex
Po
Ex
yr
"}
(7,1,1) = {"
yr
cI
PZ
kf
Ah
Ah
BZ
cI
Wx
Wx
Wx
aO
Ew
ag
CR
Dl
"}
(8,1,1) = {"
yr
cI
cI
cN
Ah
Ah
BZ
cI
Ex
Ex
Ex
eS
kS
Wx
Zs
yr
"}
(9,1,1) = {"
yr
cI
cI
Oh
Ah
Ah
BZ
De
lC
Hw
iJ
Po
We
YH
Ex
yr
"}
(10,1,1) = {"
yr
yV
yr
kf
Ah
Ah
BZ
cI
br
Sy
Po
Yd
Po
ag
Ex
yr
"}
(11,1,1) = {"
yr
yr
yr
Ah
Ah
dl
lT
cI
Ex
xv
Og
Yd
sx
sx
Ex
yr
"}
(12,1,1) = {"
yr
yr
cI
lh
LH
yD
xQ
sS
Dc
yU
hD
YF
CR
Wx
RQ
yr
"}
(13,1,1) = {"
yr
Ex
lC
JC
ag
CR
CR
HM
pM
pd
MC
Px
CC
GU
Po
yr
"}
(14,1,1) = {"
yr
Ex
GU
xJ
Yd
cC
Yd
Hw
nb
tX
we
DA
Ex
Ng
Ex
yr
"}
(15,1,1) = {"
yr
eS
Ex
Ex
Ex
bH
RW
sS
CR
QO
uD
Su
Fu
Ex
yr
yr
"}
(16,1,1) = {"
yr
yr
yr
yr
yr
yr
yr
yr
yr
yr
yr
yr
yr
yr
yr
jw
"}
