//MAP CONVERTED BY dmm2tgm.py THIS HEADER COMMENT PREVENTS RECONVERSION, DO NOT REMOVE
"bz" = (
/turf/open/floor/spooktime/beach/coasts/coastN,
/area/hilbertshotel)
"cq" = (
/obj/structure/chair/sofa/corp{
	dir = 1
	},
/obj/machinery/light{
	light_color = "#cee5d2"
	},
/turf/open/floor/carpet/royalblue,
/area/hilbertshotel)
"ct" = (
/turf/open/floor/spooktime/beach/coasts/watercoastN{
	barefootstep = "water";
	clawfootstep = "water";
	footstep = "water";
	heavyfootstep = "water"
	},
/area/hilbertshotel)
"cR" = (
/obj/machinery/door/morgue,
/turf/open/floor/holofloor/wood,
/area/hilbertshotel)
"dP" = (
/obj/effect/turf_decal/siding/wood{
	dir = 1
	},
/obj/item/kirbyplants/random,
/turf/open/floor/wood/wood_large,
/area/hilbertshotel)
"go" = (
/obj/structure/toilet{
	dir = 4
	},
/turf/open/indestructible/hoteltile,
/area/hilbertshotel)
"gz" = (
/obj/structure/table,
/obj/effect/spawner/lootdrop/three_course_meal,
/obj/machinery/reagentgrinder{
	pixel_y = 8
	},
/obj/item/sharpener{
	pixel_x = -10;
	pixel_y = -8
	},
/turf/open/floor/plasteel/cafeteria,
/area/hilbertshotel)
"hd" = (
/obj/structure/chair/sofa/corp{
	dir = 1
	},
/turf/open/floor/carpet/royalblue,
/area/hilbertshotel)
"hp" = (
/obj/effect/turf_decal/siding/wood{
	dir = 8
	},
/obj/effect/turf_decal/siding/wood{
	dir = 4
	},
/obj/machinery/door/morgue,
/turf/open/floor/holofloor/wood,
/area/hilbertshotel)
"hR" = (
/obj/machinery/door/morgue,
/turf/open/floor/wood/wood_large,
/area/hilbertshotel)
"is" = (
/obj/structure/lattice,
/turf/closed/indestructible/sandstone,
/area/hilbertshotel)
"iE" = (
/obj/item/toy/beach_ball,
/turf/open/floor/spooktime/beach/water,
/area/hilbertshotel)
"jf" = (
/obj/machinery/light{
	dir = 8;
	light_color = "#e8eaff"
	},
/turf/open/floor/carpet/red,
/area/hilbertshotel)
"jP" = (
/obj/machinery/light{
	light_color = "#cee5d2"
	},
/turf/open/floor/holofloor/wood,
/area/hilbertshotel)
"jQ" = (
/obj/structure/table,
/obj/structure/bedsheetbin/towel,
/obj/machinery/light{
	dir = 8;
	light_color = "#e8eaff"
	},
/turf/open/indestructible/hoteltile,
/area/hilbertshotel)
"li" = (
/obj/effect/turf_decal/siding/wood{
	dir = 8
	},
/turf/open/floor/plasteel/cafeteria,
/area/hilbertshotel)
"lY" = (
/obj/machinery/light{
	light_color = "#c9d3e8"
	},
/turf/open/floor/wood/wood_large,
/area/hilbertshotel)
"me" = (
/obj/machinery/vending/kink{
	onstation = 0;
	shut_up = 1
	},
/turf/open/floor/wood/wood_large,
/area/hilbertshotel)
"no" = (
/obj/item/kirbyplants/random,
/turf/open/floor/wood/wood_large,
/area/hilbertshotel)
"oh" = (
/turf/closed/indestructible/sandstone,
/area/hilbertshotel)
"oK" = (
/obj/structure/curtain{
	pixel_y = 32
	},
/obj/structure/bed/double,
/obj/item/bedsheet/black/double,
/turf/open/floor/carpet/red,
/area/hilbertshotel)
"oQ" = (
/obj/machinery/telecomms/relay/preset/auto,
/turf/open/floor/catwalk_floor,
/area/hilbertshotel)
"oS" = (
/turf/open/floor/carpet/red,
/area/hilbertshotel)
"pS" = (
/obj/machinery/light_switch/directional/south,
/turf/open/floor/wood/wood_large,
/area/hilbertshotel)
"ri" = (
/obj/structure/closet/cabinet,
/turf/open/floor/wood/wood_large,
/area/hilbertshotel)
"rs" = (
/turf/open/indestructible/hoteltile,
/area/hilbertshotel)
"vj" = (
/obj/structure/chair/sofa/corp/left{
	dir = 1
	},
/turf/open/floor/carpet/royalblue,
/area/hilbertshotel)
"wU" = (
/obj/machinery/light{
	dir = 1
	},
/turf/open/floor/wood/wood_large,
/area/hilbertshotel)
"ya" = (
/obj/structure/curtain{
	pixel_y = 32
	},
/obj/structure/table/wood,
/obj/item/reagent_containers/food/condiment/peppermill{
	pixel_x = 6
	},
/obj/item/reagent_containers/food/condiment/saltshaker,
/obj/effect/spawner/lootdrop/three_course_meal,
/turf/open/floor/holofloor/wood,
/area/hilbertshotel)
"zK" = (
/turf/open/floor/spooktime/beach/water,
/area/hilbertshotel)
"Ag" = (
/turf/open/floor/spooktime/beach/coasts/coastNW,
/area/hilbertshotel)
"AL" = (
/turf/open/floor/spooktime/beach/coasts/innerN,
/area/hilbertshotel)
"BU" = (
/obj/effect/turf_decal/siding/wood{
	dir = 4
	},
/obj/effect/turf_decal/siding/wood{
	dir = 8
	},
/obj/machinery/door/morgue,
/turf/open/floor/holofloor/wood,
/area/hilbertshotel)
"Ce" = (
/obj/structure/curtain{
	pixel_y = 32
	},
/obj/structure/dresser,
/turf/open/floor/carpet/red,
/area/hilbertshotel)
"Dh" = (
/turf/open/floor/spooktime/beach/coasts/watercoastN,
/area/hilbertshotel)
"DB" = (
/obj/structure/chair/sofa/left{
	dir = 1
	},
/turf/open/floor/plating/beach/sand,
/area/hilbertshotel)
"DE" = (
/obj/structure/chair/sofa/middle{
	dir = 1
	},
/turf/open/floor/plating/beach/sand,
/area/hilbertshotel)
"Et" = (
/obj/structure/table,
/obj/item/storage/fancy/heart_box,
/obj/item/paper/fluff/hilbertshotel/welcomeletter,
/turf/open/floor/carpet/royalblue,
/area/hilbertshotel)
"ED" = (
/obj/structure/lattice,
/turf/closed/indestructible/wood,
/area/hilbertshotel)
"FI" = (
/obj/effect/spawner/structure/window/reinforced,
/turf/open/floor/plating,
/area/hilbertshotel)
"Gq" = (
/obj/structure/table,
/obj/item/reagent_containers/food/drinks/beer,
/obj/item/reagent_containers/food/drinks/beer{
	pixel_x = -9
	},
/obj/item/reagent_containers/food/drinks/beer{
	pixel_x = 8;
	pixel_y = 8
	},
/turf/open/floor/carpet/royalblue,
/area/hilbertshotel)
"Gu" = (
/obj/structure/chair/sofa/corp/corner{
	dir = 8
	},
/turf/open/floor/carpet/royalblue,
/area/hilbertshotel)
"Ha" = (
/turf/open/floor/wood/wood_large,
/area/hilbertshotel)
"Hw" = (
/obj/structure/curtain{
	pixel_y = 32
	},
/obj/structure/chair/wood{
	dir = 4
	},
/turf/open/floor/holofloor/wood,
/area/hilbertshotel)
"LK" = (
/obj/structure/chair/wood{
	dir = 1
	},
/turf/open/floor/holofloor/wood,
/area/hilbertshotel)
"Ms" = (
/obj/structure/chair/sofa/corp/left{
	dir = 8
	},
/turf/open/floor/carpet/royalblue,
/area/hilbertshotel)
"Ow" = (
/turf/open/floor/catwalk_floor,
/area/hilbertshotel)
"Pb" = (
/turf/closed/indestructible/hoteldoor{
	icon_state = "door_closed";
	icon = 'icons/obj/doors/puzzledoor/default.dmi'
	},
/area/hilbertshotel)
"Pw" = (
/obj/machinery/light{
	dir = 1
	},
/obj/effect/turf_decal/siding/wood{
	dir = 8
	},
/turf/open/floor/plasteel/cafeteria,
/area/hilbertshotel)
"PX" = (
/turf/open/floor/plating/beach/sand,
/area/hilbertshotel)
"QT" = (
/obj/machinery/jukebox{
	req_one_access = null;
	area_limited = 1
	},
/turf/open/floor/wood/wood_large,
/area/hilbertshotel)
"QV" = (
/obj/effect/turf_decal/siding/wood,
/obj/effect/turf_decal/siding/wood{
	dir = 1
	},
/obj/machinery/door/morgue,
/turf/open/floor/holofloor/wood,
/area/hilbertshotel)
"Rk" = (
/obj/machinery/light{
	dir = 1;
	light_color = "#cee5d2"
	},
/turf/open/floor/wood/wood_large,
/area/hilbertshotel)
"Sc" = (
/obj/structure/mineral_door/wood,
/turf/open/floor/holofloor/wood,
/area/hilbertshotel)
"SJ" = (
/obj/machinery/vending/boozeomat{
	onstation = 0;
	shut_up = 1
	},
/turf/open/floor/holofloor/wood,
/area/hilbertshotel)
"TA" = (
/obj/structure/chair/wood{
	dir = 8
	},
/obj/structure/curtain{
	pixel_y = 32
	},
/turf/open/floor/holofloor/wood,
/area/hilbertshotel)
"TP" = (
/turf/open/floor/spooktime/beach/coasts/coastNE,
/area/hilbertshotel)
"Ua" = (
/obj/machinery/shower{
	desc = "Despite their age, they seem clean and capable of providing hot water just as well as their modern counterparts. Hopefully Nanotrasen cleaned the water pipes this well...";
	pixel_y = -1;
	dir = 4
	},
/obj/effect/turf_decal/siding/thinplating/end{
	dir = 4
	},
/obj/structure/window/reinforced/tinted,
/turf/open/indestructible/hoteltile,
/area/hilbertshotel)
"UM" = (
/obj/machinery/vending/dinnerware{
	contraband = list(/obj/item/kitchen/rollingpin=2,/obj/item/kitchen/knife/butcher=2,/obj/item/reagent_containers/food/condiment/flour=4);
	shut_up = 1
	},
/turf/open/floor/plasteel/cafeteria,
/area/hilbertshotel)
"UO" = (
/obj/structure/table,
/obj/item/pizzabox/meat{
	pixel_y = 7
	},
/turf/open/floor/carpet/royalblue,
/area/hilbertshotel)
"Xe" = (
/turf/open/floor/spooktime/beach/coasts/innerE,
/area/hilbertshotel)
"XM" = (
/turf/open/floor/holofloor/wood,
/area/hilbertshotel)
"XO" = (
/obj/structure/curtain{
	pixel_y = 32
	},
/obj/structure/table/wood,
/obj/item/flashlight/lamp/green{
	pixel_y = 2
	},
/turf/open/floor/carpet/red,
/area/hilbertshotel)
"Ys" = (
/obj/structure/chair/sofa/right{
	dir = 1
	},
/turf/open/floor/plating/beach/sand,
/area/hilbertshotel)
"Yw" = (
/obj/effect/turf_decal/siding/wood{
	dir = 1
	},
/turf/open/floor/wood/wood_large,
/area/hilbertshotel)
"YK" = (
/obj/machinery/door/window/southleft,
/turf/open/indestructible/hoteltile,
/area/hilbertshotel)
"YR" = (
/turf/closed/indestructible/wood,
/area/hilbertshotel)
"Zc" = (
/obj/structure/fluff/beach_umbrella,
/turf/open/floor/spooktime/beach/coasts/coastN,
/area/hilbertshotel)
"ZQ" = (
/obj/structure/table,
/obj/machinery/microwave{
	pixel_y = 6
	},
/turf/open/floor/plasteel/cafeteria,
/area/hilbertshotel)

(1,1,1) = {"
is
is
is
oh
oh
oh
oh
oh
oh
YR
YR
YR
YR
ED
ED
ED
"}
(2,1,1) = {"
is
ct
zK
zK
zK
zK
TP
AL
PX
YR
ri
YR
Ua
jQ
go
ED
"}
(3,1,1) = {"
is
ct
zK
zK
zK
zK
Dh
bz
PX
YR
wU
YR
YK
rs
rs
ED
"}
(4,1,1) = {"
oh
zK
zK
Dh
zK
zK
Dh
bz
PX
Sc
pS
YR
YR
cR
YR
YR
"}
(5,1,1) = {"
oh
zK
zK
Dh
zK
zK
Ag
Xe
YR
YR
BU
YR
QT
Ha
oS
Pb
"}
(6,1,1) = {"
oh
zK
zK
Dh
zK
zK
bz
YR
YR
SJ
XM
YR
no
Ha
no
YR
"}
(7,1,1) = {"
oh
zK
zK
zK
Dh
Ag
Xe
FI
Hw
XM
XM
YR
Rk
Ha
Ha
YR
"}
(8,1,1) = {"
oh
zK
Dh
zK
Dh
Zc
PX
FI
ya
LK
jP
YR
Ha
Et
vj
YR
"}
(9,1,1) = {"
oh
zK
Dh
zK
Dh
bz
PX
FI
TA
XM
XM
QV
Ha
UO
cq
YR
"}
(10,1,1) = {"
oh
zK
zK
zK
iE
TP
AL
YR
Pw
li
li
YR
Ha
Gq
hd
YR
"}
(11,1,1) = {"
oh
zK
zK
Dh
zK
zK
bz
YR
gz
ZQ
UM
YR
Rk
Ms
Gu
YR
"}
(12,1,1) = {"
oh
zK
zK
Dh
zK
Dh
bz
YR
YR
YR
YR
YR
hp
YR
YR
YR
"}
(13,1,1) = {"
oh
ct
zK
Dh
zK
Dh
bz
DB
FI
Ce
jf
Yw
Ha
hR
me
YR
"}
(14,1,1) = {"
is
ct
zK
zK
zK
Dh
bz
DE
FI
oK
oS
Yw
lY
YR
YR
YR
"}
(15,1,1) = {"
is
ct
zK
zK
zK
zK
bz
Ys
FI
XO
oS
dP
ri
YR
YR
oQ
"}
(16,1,1) = {"
is
is
is
oh
oh
oh
oh
oh
YR
YR
YR
YR
YR
YR
Ow
Ow
"}
