//MAP CONVERTED BY dmm2tgm.py THIS HEADER COMMENT PREVENTS RECONVERSION, DO NOT REMOVE
"ah" = (
/turf/open/floor/mineral/plastitanium/red,
/area/hilbertshotel)
"as" = (
/obj/machinery/airalarm/all_access{
	dir = 4;
	pixel_x = -24
	},
/turf/open/floor/carpet/red,
/area/hilbertshotel)
"bk" = (
/obj/structure/table/reinforced,
/turf/open/floor/plasteel/cafeteria,
/area/hilbertshotel)
"bK" = (
/obj/effect/turf_decal/siding/thinplating/dark{
	dir = 5
	},
/obj/effect/turf_decal/siding/thinplating/dark{
	dir = 9
	},
/obj/machinery/door/morgue,
/obj/machinery/atmospherics/pipe/simple/supply/hidden{
	dir = 4;
	piping_layer = 1
	},
/obj/machinery/atmospherics/pipe/simple/scrubbers/hidden/layer3{
	dir = 4
	},
/turf/open/floor/mineral/plastitanium/red,
/area/hilbertshotel)
"bV" = (
/obj/structure/table/reinforced,
/obj/effect/spawner/lootdrop/three_course_meal,
/obj/effect/spawner/lootdrop/three_course_meal,
/obj/effect/spawner/lootdrop/three_course_meal,
/obj/effect/spawner/lootdrop/three_course_meal,
/obj/machinery/light{
	dir = 1
	},
/turf/open/floor/plasteel/cafeteria,
/area/hilbertshotel)
"ch" = (
/obj/machinery/atmospherics/components/unary/vent_scrubber/hilbertshotel/layer3,
/obj/structure/sink/kitchen,
/turf/open/indestructible/hoteltile,
/area/hilbertshotel)
"cm" = (
/obj/effect/turf_decal/siding/thinplating/dark{
	dir = 1
	},
/obj/machinery/atmospherics/components/unary/vent_scrubber/hilbertshotel/layer3,
/turf/open/floor/mineral/plastitanium/red,
/area/hilbertshotel)
"cC" = (
/obj/structure/chair/office{
	dir = 4
	},
/obj/effect/turf_decal/siding/thinplating/dark{
	dir = 8
	},
/obj/effect/turf_decal/siding/thinplating/dark,
/turf/open/floor/mineral/plastitanium,
/area/hilbertshotel)
"dx" = (
/obj/structure/window/reinforced/tinted{
	dir = 1
	},
/obj/structure/table,
/obj/machinery/atmospherics/pipe/simple/supply/hidden{
	dir = 4;
	piping_layer = 1
	},
/obj/machinery/atmospherics/pipe/simple/scrubbers/hidden/layer3{
	dir = 4
	},
/obj/item/dildo/flared/gigantic,
/turf/open/floor/mineral/titanium/tiled/white,
/area/hilbertshotel)
"dy" = (
/obj/structure/dresser,
/turf/open/floor/carpet/red,
/area/hilbertshotel)
"eK" = (
/obj/effect/spawner/lootdrop/three_course_meal,
/obj/structure/table,
/obj/machinery/atmospherics/components/unary/vent_scrubber/hilbertshotel/layer3,
/obj/structure/table/reinforced,
/turf/open/floor/mineral/plastitanium/red,
/area/hilbertshotel)
"eT" = (
/obj/effect/turf_decal/siding/thinplating/dark{
	dir = 8
	},
/obj/effect/turf_decal/siding/thinplating/dark,
/turf/open/floor/mineral/plastitanium/red,
/area/hilbertshotel)
"fB" = (
/obj/structure/chair/office{
	dir = 4
	},
/obj/effect/turf_decal/siding/thinplating/dark{
	dir = 8
	},
/obj/machinery/atmospherics/pipe/simple/scrubbers/hidden/layer3{
	dir = 4
	},
/turf/open/floor/mineral/plastitanium,
/area/hilbertshotel)
"fE" = (
/turf/open/floor/carpet/red,
/area/hilbertshotel)
"fR" = (
/obj/machinery/atmospherics/components/unary/vent_pump/on{
	dir = 4
	},
/turf/open/floor/carpet/red,
/area/hilbertshotel)
"gd" = (
/obj/structure/window/reinforced/tinted{
	dir = 1
	},
/obj/structure/table,
/obj/machinery/atmospherics/pipe/manifold/supply/hidden{
	dir = 4
	},
/obj/machinery/atmospherics/pipe/manifold/scrubbers/hidden/layer3{
	dir = 4
	},
/obj/item/restraints/handcuffs/fake,
/turf/open/floor/mineral/titanium/tiled/white,
/area/hilbertshotel)
"gY" = (
/obj/machinery/shower{
	dir = 4
	},
/obj/structure/window/reinforced/tinted,
/obj/structure/window/reinforced/tinted,
/obj/structure/window/reinforced/tinted,
/obj/structure/window/reinforced/tinted,
/turf/open/indestructible/hoteltile,
/area/hilbertshotel)
"hh" = (
/obj/machinery/vending/kink{
	shut_up = 1
	},
/turf/open/floor/mineral/titanium/tiled/white,
/area/hilbertshotel)
"ht" = (
/obj/machinery/atmospherics/pipe/simple/scrubbers/hidden/layer3{
	dir = 4
	},
/turf/open/floor/mineral/plastitanium/red,
/area/hilbertshotel)
"hx" = (
/obj/structure/chair{
	dir = 8
	},
/turf/open/floor/mineral/plastitanium/red,
/area/hilbertshotel)
"hB" = (
/obj/structure/table/reinforced,
/obj/machinery/microwave{
	pixel_x = -2;
	pixel_y = 6
	},
/obj/machinery/microwave{
	pixel_x = -2;
	pixel_y = 6
	},
/obj/machinery/microwave{
	pixel_x = -2;
	pixel_y = 6
	},
/obj/machinery/microwave{
	pixel_x = -2;
	pixel_y = 6
	},
/turf/open/floor/plasteel/cafeteria,
/area/hilbertshotel)
"hZ" = (
/obj/effect/turf_decal/siding/thinplating/dark{
	dir = 8
	},
/obj/machinery/atmospherics/components/unary/vent_pump/on{
	dir = 4
	},
/turf/open/floor/mineral/plastitanium/red,
/area/hilbertshotel)
"jf" = (
/obj/structure/closet/cabinet,
/obj/machinery/light{
	dir = 8
	},
/turf/open/floor/carpet/red,
/area/hilbertshotel)
"jp" = (
/obj/structure/chair/office/dark{
	dir = 1
	},
/obj/machinery/atmospherics/pipe/simple/supply/hidden{
	dir = 4
	},
/turf/open/floor/mineral/plastitanium,
/area/hilbertshotel)
"jy" = (
/obj/machinery/atmospherics/pipe/manifold/supply/hidden{
	dir = 1
	},
/obj/machinery/meter,
/obj/structure/lattice,
/turf/open/space/basic,
/area/hilbertshotel)
"jB" = (
/obj/machinery/atmospherics/components/unary/tank/air{
	dir = 8
	},
/obj/structure/lattice,
/turf/open/space/basic,
/area/hilbertshotel)
"lN" = (
/obj/effect/turf_decal/siding/thinplating/dark{
	dir = 1
	},
/obj/effect/turf_decal/siding/thinplating/dark{
	dir = 4
	},
/obj/machinery/atmospherics/pipe/simple/supply/hidden{
	dir = 1
	},
/obj/machinery/atmospherics/pipe/simple/scrubbers/hidden/layer3{
	dir = 10
	},
/turf/open/floor/mineral/plastitanium,
/area/hilbertshotel)
"mf" = (
/obj/structure/bed/double{
	dir = 1
	},
/obj/item/bedsheet/random/double{
	dir = 1
	},
/turf/open/floor/carpet/red,
/area/hilbertshotel)
"my" = (
/obj/effect/turf_decal/siding/wood{
	dir = 8
	},
/obj/effect/turf_decal/siding/wood{
	dir = 4;
	layer = 2.2
	},
/obj/machinery/atmospherics/pipe/simple/supply/hidden{
	dir = 9
	},
/turf/open/floor/plating/smooth/grass/lavaland_jungle,
/area/hilbertshotel)
"mN" = (
/obj/effect/turf_decal/siding/wood{
	dir = 4;
	layer = 2.2
	},
/obj/effect/turf_decal/siding/wood{
	dir = 8;
	layer = 2.2
	},
/turf/open/floor/plating/smooth/grass/lavaland_jungle,
/area/hilbertshotel)
"mR" = (
/obj/structure/chair/office/dark{
	dir = 4
	},
/obj/effect/turf_decal/siding/thinplating/dark{
	dir = 8
	},
/obj/machinery/atmospherics/components/unary/vent_pump/on{
	dir = 4
	},
/obj/machinery/light{
	dir = 8
	},
/turf/open/floor/mineral/plastitanium,
/area/hilbertshotel)
"nk" = (
/obj/structure/chair/office/dark,
/obj/structure/chair/office/dark,
/obj/effect/turf_decal/siding/thinplating/dark{
	dir = 1
	},
/obj/machinery/atmospherics/pipe/manifold/scrubbers/hidden/layer3,
/turf/open/floor/mineral/plastitanium,
/area/hilbertshotel)
"oi" = (
/obj/machinery/vending/boozeomat{
	shut_up = 1
	},
/turf/open/floor/plasteel/cafeteria,
/area/hilbertshotel)
"op" = (
/obj/machinery/atmospherics/components/unary/vent_pump/on{
	dir = 4
	},
/turf/open/indestructible/hoteltile,
/area/hilbertshotel)
"oU" = (
/obj/structure/sink/kitchen{
	pixel_y = 28
	},
/turf/open/floor/plasteel/cafeteria,
/area/hilbertshotel)
"pn" = (
/obj/machinery/light,
/turf/open/floor/carpet/red,
/area/hilbertshotel)
"ps" = (
/obj/effect/turf_decal/siding/thinplating/dark{
	dir = 4
	},
/obj/machinery/atmospherics/pipe/simple/supply/hidden{
	dir = 1
	},
/obj/machinery/atmospherics/pipe/simple/scrubbers/hidden/layer3,
/turf/open/floor/mineral/plastitanium,
/area/hilbertshotel)
"pH" = (
/turf/open/floor/plasteel/cafeteria,
/area/hilbertshotel)
"qA" = (
/obj/effect/turf_decal/siding/thinplating/dark,
/obj/effect/turf_decal/siding/thinplating/dark{
	dir = 8
	},
/turf/open/floor/mineral/plastitanium,
/area/hilbertshotel)
"qJ" = (
/obj/structure/chair/sofa/corp/right{
	color = "#DE3A3A";
	dir = 1
	},
/turf/open/floor/carpet/red,
/area/hilbertshotel)
"ry" = (
/obj/machinery/atmospherics/pipe/simple/scrubbers/hidden/layer3{
	dir = 5
	},
/turf/open/floor/mineral/plastitanium/red,
/area/hilbertshotel)
"rz" = (
/obj/effect/turf_decal/siding/thinplating/dark{
	dir = 8
	},
/obj/machinery/atmospherics/pipe/simple/supply/hidden{
	dir = 4
	},
/turf/open/floor/mineral/plastitanium,
/area/hilbertshotel)
"rE" = (
/obj/structure/chair/office,
/obj/machinery/atmospherics/pipe/simple/supply/hidden{
	dir = 4;
	piping_layer = 1
	},
/obj/machinery/atmospherics/pipe/simple/scrubbers/hidden/layer3{
	dir = 5
	},
/turf/open/floor/mineral/plastitanium/red,
/area/hilbertshotel)
"rF" = (
/obj/structure/table/wood,
/obj/item/storage/fancy/candle_box{
	pixel_x = 4
	},
/obj/item/storage/fancy/candle_box{
	pixel_x = 4
	},
/obj/item/storage/fancy/candle_box{
	pixel_x = 4
	},
/obj/item/storage/fancy/candle_box{
	pixel_x = 4
	},
/obj/machinery/light{
	dir = 8
	},
/turf/open/floor/carpet/red,
/area/hilbertshotel)
"sn" = (
/obj/structure/chair/sofa/corp{
	color = "#DE3A3A";
	dir = 1
	},
/turf/open/floor/carpet/red,
/area/hilbertshotel)
"sX" = (
/obj/machinery/computer{
	dir = 8
	},
/obj/effect/turf_decal/siding/thinplating/dark{
	dir = 4
	},
/obj/machinery/atmospherics/pipe/simple/supply/hidden{
	dir = 1
	},
/obj/machinery/atmospherics/pipe/manifold/scrubbers/hidden{
	dir = 4;
	piping_layer = 3;
	pixel_x = 5;
	pixel_y = 5
	},
/obj/machinery/light{
	dir = 4
	},
/turf/open/floor/mineral/plastitanium,
/area/hilbertshotel)
"tZ" = (
/obj/structure/table,
/obj/machinery/atmospherics/pipe/simple/supply/hidden{
	dir = 1
	},
/obj/machinery/atmospherics/pipe/simple/scrubbers/hidden/layer3,
/obj/item/electropack/vibrator/small,
/turf/open/floor/mineral/titanium/tiled/white,
/area/hilbertshotel)
"ub" = (
/obj/structure/chair{
	dir = 4
	},
/turf/open/floor/mineral/plastitanium/red,
/area/hilbertshotel)
"uy" = (
/obj/machinery/atmospherics/components/unary/vent_pump/on{
	dir = 4
	},
/obj/structure/table/reinforced,
/turf/open/floor/plasteel/cafeteria,
/area/hilbertshotel)
"uB" = (
/obj/machinery/atmospherics/components/unary/vent_scrubber/hilbertshotel/layer3{
	dir = 4
	},
/turf/open/floor/mineral/plastitanium/red,
/area/hilbertshotel)
"uN" = (
/obj/machinery/atmospherics/components/unary/outlet_injector/hilbertshotel/layer3,
/obj/structure/lattice,
/turf/open/space/basic,
/area/hilbertshotel)
"vs" = (
/obj/machinery/atmospherics/pipe/simple/supply/hidden{
	dir = 4
	},
/turf/open/floor/carpet/red,
/area/hilbertshotel)
"wg" = (
/obj/machinery/atmospherics/pipe/simple/supply/hidden{
	dir = 4;
	piping_layer = 1
	},
/obj/machinery/atmospherics/pipe/simple/scrubbers/hidden/layer3{
	dir = 4
	},
/turf/closed/indestructible/syndicate,
/area/hilbertshotel)
"wm" = (
/obj/machinery/door/morgue,
/turf/open/floor/plating/smooth/grass/lavaland_jungle,
/area/hilbertshotel)
"ww" = (
/obj/structure/window/reinforced/tinted{
	dir = 1
	},
/obj/structure/table,
/obj/machinery/atmospherics/pipe/simple/supply/hidden{
	dir = 4;
	piping_layer = 1
	},
/obj/machinery/atmospherics/pipe/simple/scrubbers/hidden/layer3{
	dir = 4
	},
/obj/item/electropack/vibrator,
/turf/open/floor/mineral/titanium/tiled/white,
/area/hilbertshotel)
"wC" = (
/obj/structure/chair/sofa/corp/left{
	color = "#DE3A3A";
	dir = 1
	},
/turf/open/floor/carpet/red,
/area/hilbertshotel)
"xo" = (
/obj/structure/flora/junglebush,
/obj/structure/window/reinforced/tinted,
/obj/structure/window{
	dir = 1
	},
/obj/structure/window{
	dir = 1
	},
/obj/structure/window{
	dir = 1
	},
/obj/structure/flora/junglebush/large,
/turf/open/floor/grass/grass0,
/area/hilbertshotel)
"xP" = (
/obj/structure/sign/poster/random,
/turf/closed/indestructible/syndicate,
/area/hilbertshotel)
"xT" = (
/obj/machinery/door/morgue,
/obj/machinery/atmospherics/pipe/simple/supply/hidden{
	dir = 4
	},
/turf/open/floor/mineral/plastitanium/red,
/area/hilbertshotel)
"zd" = (
/turf/open/space/bluespace,
/area/hilbertshotel)
"zs" = (
/obj/effect/turf_decal/siding/thinplating/dark{
	dir = 8
	},
/turf/open/floor/mineral/plastitanium/red,
/area/hilbertshotel)
"Al" = (
/obj/structure/sign/poster/contraband/syndicate_pistol,
/turf/closed/indestructible/syndicate,
/area/hilbertshotel)
"Ao" = (
/obj/machinery/vending/kink{
	shut_up = 1
	},
/turf/open/floor/plating/smooth/grass/lavaland_jungle,
/area/hilbertshotel)
"Ax" = (
/obj/machinery/atmospherics/pipe/simple/scrubbers/hidden/layer3,
/obj/structure/sign/poster/random,
/turf/closed/indestructible/syndicate,
/area/hilbertshotel)
"AT" = (
/obj/effect/turf_decal/siding/wood/corner{
	dir = 4;
	layer = 2.2
	},
/obj/machinery/light_switch/directional/south,
/obj/effect/turf_decal/siding/wood{
	dir = 8;
	layer = 2.2
	},
/turf/open/floor/plating/smooth/grass/lavaland_jungle,
/area/hilbertshotel)
"Bj" = (
/obj/effect/spawner/lootdrop/three_course_meal,
/obj/structure/table,
/obj/machinery/light{
	dir = 1
	},
/turf/open/floor/mineral/plastitanium/red,
/area/hilbertshotel)
"BH" = (
/obj/structure/toilet{
	dir = 8
	},
/obj/machinery/atmospherics/pipe/simple/supply/hidden{
	dir = 9
	},
/obj/machinery/atmospherics/pipe/simple/scrubbers/hidden/layer3{
	dir = 9
	},
/turf/open/indestructible/hoteltile,
/area/hilbertshotel)
"Cw" = (
/obj/machinery/door/morgue,
/obj/machinery/atmospherics/pipe/simple/supply/hidden,
/turf/open/floor/mineral/plastitanium/red,
/area/hilbertshotel)
"Cz" = (
/obj/machinery/atmospherics/pipe/manifold/supply/hidden{
	dir = 1
	},
/obj/machinery/light{
	dir = 4
	},
/obj/machinery/atmospherics/pipe/manifold/scrubbers/hidden/layer3{
	dir = 8
	},
/turf/open/indestructible/hoteltile,
/area/hilbertshotel)
"CS" = (
/obj/structure/sign/poster/contraband/syndicate_recruitment,
/turf/closed/indestructible/syndicate,
/area/hilbertshotel)
"DB" = (
/obj/machinery/atmospherics/components/unary/tank/air{
	dir = 4
	},
/obj/structure/lattice,
/turf/open/space/basic,
/area/hilbertshotel)
"Et" = (
/obj/effect/turf_decal/siding/thinplating/dark,
/turf/open/floor/mineral/plastitanium/red,
/area/hilbertshotel)
"Fp" = (
/obj/machinery/atmospherics/pipe/simple/supply/hidden{
	dir = 5
	},
/turf/open/floor/carpet/red,
/area/hilbertshotel)
"Fs" = (
/obj/effect/turf_decal/siding/thinplating/dark{
	dir = 4
	},
/obj/machinery/atmospherics/pipe/simple/supply/hidden{
	dir = 4;
	piping_layer = 1
	},
/obj/machinery/atmospherics/pipe/simple/scrubbers/hidden/layer3{
	dir = 4
	},
/turf/open/floor/mineral/plastitanium/red,
/area/hilbertshotel)
"GT" = (
/obj/structure/chair/office/dark,
/obj/effect/turf_decal/siding/thinplating/dark{
	dir = 1
	},
/obj/machinery/atmospherics/pipe/manifold/scrubbers/hidden/layer3,
/turf/open/floor/mineral/plastitanium,
/area/hilbertshotel)
"Ir" = (
/obj/machinery/door/morgue,
/obj/machinery/atmospherics/pipe/simple/supply/hidden{
	dir = 4;
	piping_layer = 1
	},
/obj/machinery/atmospherics/pipe/simple/scrubbers/hidden/layer3{
	dir = 4
	},
/turf/open/indestructible/hoteltile,
/area/hilbertshotel)
"IF" = (
/obj/effect/turf_decal/siding/thinplating/dark{
	dir = 4
	},
/obj/machinery/atmospherics/pipe/simple/scrubbers/hidden/layer3,
/obj/machinery/atmospherics/pipe/manifold/supply/hidden{
	dir = 4
	},
/turf/open/floor/mineral/plastitanium,
/area/hilbertshotel)
"IN" = (
/obj/effect/turf_decal/siding/thinplating/dark,
/obj/effect/turf_decal/siding/thinplating/dark{
	dir = 4
	},
/turf/open/floor/mineral/plastitanium/red,
/area/hilbertshotel)
"IX" = (
/obj/structure/table,
/obj/machinery/atmospherics/pipe/simple/supply/hidden{
	dir = 9;
	piping_layer = 1
	},
/obj/machinery/atmospherics/pipe/simple/scrubbers/hidden/layer3{
	dir = 9
	},
/obj/item/restraints/handcuffs/fake/kinky,
/turf/open/floor/mineral/titanium/tiled/white,
/area/hilbertshotel)
"JH" = (
/obj/machinery/atmospherics/pipe/simple/supply/hidden,
/turf/open/floor/mineral/plastitanium/red,
/area/hilbertshotel)
"Kn" = (
/obj/structure/table/wood,
/turf/open/floor/carpet/red,
/area/hilbertshotel)
"Kx" = (
/obj/structure/table/reinforced,
/obj/machinery/atmospherics/pipe/simple/supply/hidden{
	dir = 4;
	piping_layer = 1
	},
/turf/open/floor/mineral/plastitanium,
/area/hilbertshotel)
"KA" = (
/obj/machinery/atmospherics/pipe/simple/scrubbers/hidden/layer3{
	dir = 4
	},
/turf/closed/indestructible/syndicate,
/area/hilbertshotel)
"Mf" = (
/obj/structure/chair/office/dark{
	dir = 8
	},
/obj/effect/turf_decal/siding/thinplating/dark{
	dir = 4
	},
/obj/machinery/atmospherics/pipe/manifold/supply/hidden{
	dir = 4
	},
/obj/machinery/atmospherics/pipe/simple/scrubbers/hidden/layer3,
/obj/machinery/light{
	dir = 4
	},
/turf/open/floor/mineral/plastitanium,
/area/hilbertshotel)
"Nt" = (
/obj/structure/table/reinforced,
/obj/machinery/atmospherics/pipe/simple/supply/hidden{
	dir = 4;
	piping_layer = 1
	},
/obj/structure/showcase/machinery/tv,
/turf/open/floor/mineral/plastitanium,
/area/hilbertshotel)
"Nw" = (
/obj/machinery/telecomms/relay/preset/auto,
/turf/open/floor/catwalk_floor,
/area/hilbertshotel)
"Nz" = (
/obj/machinery/atmospherics/pipe/simple/supply/hidden{
	dir = 4;
	piping_layer = 1
	},
/obj/machinery/atmospherics/pipe/simple/scrubbers/hidden/layer3{
	dir = 4
	},
/turf/open/indestructible/hoteltile,
/area/hilbertshotel)
"NN" = (
/obj/machinery/light_switch/directional/south,
/obj/machinery/light,
/turf/open/floor/carpet/red,
/area/hilbertshotel)
"NO" = (
/obj/structure/sign/poster/contraband/syndicate_logo,
/turf/closed/indestructible/syndicate,
/area/hilbertshotel)
"Op" = (
/obj/machinery/door/morgue,
/turf/open/floor/mineral/plastitanium/red,
/area/hilbertshotel)
"Qn" = (
/obj/effect/turf_decal/siding/wood{
	dir = 4;
	layer = 2.2
	},
/obj/machinery/atmospherics/components/unary/vent_scrubber/hilbertshotel/layer3,
/obj/effect/turf_decal/siding/wood{
	dir = 8;
	layer = 2.2
	},
/turf/open/floor/plating/smooth/grass/lavaland_jungle,
/area/hilbertshotel)
"QM" = (
/turf/open/floor/mineral/plastitanium,
/area/hilbertshotel)
"RM" = (
/obj/machinery/atmospherics/pipe/simple/supply/hidden{
	dir = 1
	},
/turf/closed/indestructible/syndicate,
/area/hilbertshotel)
"So" = (
/turf/closed/indestructible/hoteldoor{
	icon_state = "door_closed";
	icon = 'icons/obj/doors/puzzledoor/default.dmi'
	},
/area/hilbertshotel)
"Ti" = (
/obj/structure/flora/junglebush,
/obj/structure/window/reinforced/tinted,
/obj/structure/window{
	dir = 4
	},
/obj/structure/window{
	dir = 4
	},
/obj/structure/window{
	dir = 4
	},
/obj/structure/window{
	dir = 4
	},
/obj/structure/window{
	dir = 1
	},
/obj/structure/window{
	dir = 1
	},
/obj/structure/window{
	dir = 1
	},
/obj/structure/flora/junglebush/large,
/turf/open/floor/grass/grass0,
/area/hilbertshotel)
"TL" = (
/turf/closed/indestructible/syndicate,
/area/hilbertshotel)
"TZ" = (
/obj/structure/flora/junglebush,
/obj/structure/window/reinforced/tinted,
/obj/structure/window{
	dir = 1
	},
/obj/structure/window{
	dir = 1
	},
/obj/structure/flora/junglebush/large,
/turf/open/floor/grass/grass0,
/area/hilbertshotel)
"Un" = (
/obj/machinery/computer{
	dir = 8
	},
/obj/effect/turf_decal/siding/thinplating/dark,
/obj/effect/turf_decal/siding/thinplating/dark{
	dir = 4
	},
/obj/machinery/atmospherics/pipe/simple/supply/hidden{
	dir = 1
	},
/obj/machinery/atmospherics/pipe/simple/scrubbers/hidden/layer3,
/turf/open/floor/mineral/plastitanium,
/area/hilbertshotel)
"XB" = (
/obj/machinery/atmospherics/pipe/simple/supply/hidden{
	dir = 10
	},
/obj/structure/table/reinforced,
/turf/open/floor/mineral/plastitanium/red,
/area/hilbertshotel)
"XF" = (
/obj/machinery/atmospherics/pipe/simple/scrubbers/hidden/layer3,
/turf/closed/indestructible/syndicate,
/area/hilbertshotel)
"Yn" = (
/obj/effect/turf_decal/siding/thinplating/dark{
	dir = 8
	},
/obj/effect/turf_decal/siding/thinplating/dark{
	dir = 1
	},
/obj/machinery/light_switch/directional/north,
/obj/machinery/atmospherics/pipe/simple/scrubbers/hidden/layer3{
	dir = 4
	},
/turf/open/floor/mineral/plastitanium,
/area/hilbertshotel)
"YA" = (
/obj/structure/table/wood,
/obj/item/flashlight/lamp/green{
	pixel_x = -10
	},
/turf/open/floor/carpet/red,
/area/hilbertshotel)
"YS" = (
/obj/effect/turf_decal/siding/wood/corner{
	layer = 2.2
	},
/obj/effect/turf_decal/siding/wood/corner{
	dir = 4;
	layer = 2.2
	},
/obj/machinery/atmospherics/pipe/simple/supply/hidden{
	dir = 6
	},
/obj/machinery/atmospherics/pipe/simple/scrubbers/hidden/layer3{
	dir = 5
	},
/obj/effect/turf_decal/siding/wood{
	dir = 8;
	layer = 2.2
	},
/turf/open/floor/plating/smooth/grass/lavaland_jungle,
/area/hilbertshotel)
"YX" = (
/obj/effect/turf_decal/siding/thinplating/dark{
	dir = 4
	},
/obj/effect/turf_decal/siding/thinplating/dark{
	dir = 1
	},
/turf/open/floor/mineral/plastitanium/red,
/area/hilbertshotel)
"Zk" = (
/obj/effect/turf_decal/siding/thinplating/dark,
/turf/open/floor/mineral/plastitanium,
/area/hilbertshotel)

(1,1,1) = {"
zd
zd
zd
zd
zd
zd
zd
zd
zd
zd
zd
zd
zd
zd
zd
zd
"}
(2,1,1) = {"
zd
TL
TL
TL
TL
TL
So
TL
TL
TL
xP
TL
TL
xP
TL
zd
"}
(3,1,1) = {"
zd
TL
hB
oi
bk
TL
fE
as
xP
rF
wC
xo
mf
jf
TL
zd
"}
(4,1,1) = {"
zd
TL
oU
pH
pH
NO
fE
NN
TL
Kn
sn
TZ
fE
dy
TL
zd
"}
(5,1,1) = {"
zd
TL
bV
uy
pH
TL
fE
fE
TL
YA
qJ
Ti
fR
fE
xP
zd
"}
(6,1,1) = {"
zd
TL
ah
XB
JH
Cw
Fp
fE
Op
mN
Qn
YS
my
AT
TL
zd
"}
(7,1,1) = {"
zd
TL
ub
ub
ah
TL
vs
fE
TL
TL
TL
Ir
TL
wm
TL
zd
"}
(8,1,1) = {"
zd
TL
Bj
eK
ry
Al
vs
pn
CS
gY
op
Nz
TL
Ao
TL
zd
"}
(9,1,1) = {"
zd
TL
hx
hx
ht
TL
vs
fE
TL
ch
Cz
BH
TL
TL
TL
zd
"}
(10,1,1) = {"
zd
TL
TL
TL
KA
TL
xT
Op
TL
TL
wg
TL
xP
TL
TL
zd
"}
(11,1,1) = {"
zd
zd
Nw
TL
Yn
mR
rz
qA
uB
ah
bK
zs
hZ
eT
TL
zd
"}
(12,1,1) = {"
zd
zd
uN
Ax
GT
Kx
jp
Zk
ht
ah
dx
cm
rE
Et
xP
zd
"}
(13,1,1) = {"
zd
zd
DB
XF
nk
Nt
jp
QM
fB
cC
ww
YX
Fs
IN
TL
zd
"}
(14,1,1) = {"
zd
zd
jy
RM
lN
Mf
IF
ps
sX
Un
gd
tZ
IX
hh
TL
zd
"}
(15,1,1) = {"
zd
zd
jB
TL
xP
TL
TL
xP
TL
TL
xP
TL
TL
xP
TL
zd
"}
(16,1,1) = {"
zd
zd
zd
zd
zd
zd
zd
zd
zd
zd
zd
zd
zd
zd
zd
zd
"}
