//MAP CONVERTED BY dmm2tgm.py THIS HEADER COMMENT PREVENTS RECONVERSION, DO NOT REMOVE
"ag" = (
/obj/effect/turf_decal/siding/wood/corner{
	dir = 4
	},
/obj/effect/turf_decal/siding/wood/corner,
/turf/open/floor/carpet,
/area/hilbertshotel)
"aO" = (
/obj/effect/turf_decal/siding/wood{
	dir = 8
	},
/turf/open/floor/wood/wood_tiled,
/area/hilbertshotel)
"aP" = (
/obj/effect/turf_decal/siding/wood{
	dir = 5
	},
/obj/structure/table/wood,
/obj/item/flashlight/lamp/green{
	pixel_x = 5;
	pixel_y = 14
	},
/obj/item/choice_beacon/box/plushie,
/turf/open/floor/carpet/royalblue,
/area/hilbertshotel)
"br" = (
/obj/effect/turf_decal/siding/wood{
	dir = 4
	},
/obj/machinery/light/small{
	dir = 4;
	pixel_y = 17
	},
/turf/open/floor/wood/wood_tiled,
/area/hilbertshotel)
"bH" = (
/obj/effect/turf_decal/siding/wood{
	dir = 6
	},
/obj/structure/closet/crate/wooden,
/obj/item/stack/sheet/mineral/wood/fifty,
/obj/item/lighter/gold,
/turf/open/floor/wood/wood_tiled,
/area/hilbertshotel)
"cC" = (
/obj/structure/chair/pew/right{
	dir = 4
	},
/obj/effect/turf_decal/siding/wood{
	dir = 8
	},
/turf/open/floor/wood/wood_tiled,
/area/hilbertshotel)
"cI" = (
/obj/effect/turf_decal/siding/wood{
	dir = 5
	},
/obj/structure/table/wood,
/obj/item/shovel,
/obj/machinery/light/floor{
	light_color = "#f27d0c";
	color = "FFB43A"
	},
/obj/item/wrench{
	pixel_x = 6
	},
/obj/item/flashlight/lantern{
	icon_state = "lantern-on";
	pixel_x = -8;
	pixel_y = 13
	},
/turf/open/floor/wood/wood_tiled,
/area/hilbertshotel)
"cN" = (
/obj/structure/table/reinforced,
/obj/machinery/microwave{
	pixel_y = 6
	},
/turf/open/floor/plasteel/cafeteria,
/area/hilbertshotel)
"dl" = (
/obj/effect/turf_decal/siding/wood,
/turf/open/floor/wood/wood_tiled,
/area/hilbertshotel)
"eS" = (
/obj/effect/turf_decal/siding/wood{
	dir = 5
	},
/obj/machinery/jukebox{
	req_one_access = null;
	one_area_play = 1
	},
/turf/open/floor/wood/wood_tiled,
/area/hilbertshotel)
"fN" = (
/obj/structure/flora/grass/green,
/turf/open/floor/plating/asteroid/snow{
	initial_gas_mix = "o2=21.78;n2=82.36;TEMP=275"
	},
/area/hilbertshotel)
"gq" = (
/obj/structure/chair/wood{
	dir = 1
	},
/turf/open/floor/plating/asteroid/snow{
	initial_gas_mix = "o2=21.78;n2=82.36;TEMP=275"
	},
/area/hilbertshotel)
"gX" = (
/obj/structure/bookcase/random/fiction,
/turf/closed/indestructible/wood,
/area/hilbertshotel)
"hA" = (
/obj/effect/turf_decal/siding/wood{
	dir = 8
	},
/obj/effect/turf_decal/siding/wood/corner,
/turf/open/floor/wood/wood_tiled,
/area/hilbertshotel)
"hD" = (
/obj/effect/turf_decal/siding/wood,
/obj/effect/turf_decal/siding/wood{
	dir = 1
	},
/obj/structure/mineral_door/wood,
/turf/open/floor/wood/wood_tiled,
/area/hilbertshotel)
"iB" = (
/obj/effect/turf_decal/siding/wood/corner{
	dir = 1
	},
/obj/effect/turf_decal/siding/wood/corner{
	dir = 8
	},
/turf/open/floor/wood/wood_tiled,
/area/hilbertshotel)
"iJ" = (
/obj/structure/fans/tiny/invisible,
/obj/effect/turf_decal/siding/wood/end{
	dir = 1
	},
/obj/structure/mineral_door/woodrustic,
/turf/open/floor/wood/wood_tiled,
/area/hilbertshotel)
"jc" = (
/obj/machinery/vending/games{
	shut_up = 1
	},
/turf/closed/indestructible/wood,
/area/hilbertshotel)
"jw" = (
/obj/machinery/telecomms/relay/preset/auto,
/turf/open/floor/catwalk_floor,
/area/hilbertshotel)
"kf" = (
/obj/structure/table/reinforced,
/obj/effect/spawner/lootdrop/three_course_meal,
/obj/effect/spawner/lootdrop/three_course_meal,
/turf/open/floor/plasteel/cafeteria,
/area/hilbertshotel)
"kS" = (
/obj/effect/turf_decal/siding/wood{
	dir = 8
	},
/obj/structure/closet/cabinet{
	pixel_x = -6
	},
/turf/open/floor/wood/wood_tiled,
/area/hilbertshotel)
"kY" = (
/obj/structure/flora/grass/green,
/obj/machinery/light/small{
	dir = 1
	},
/turf/open/floor/plating/asteroid/snow{
	initial_gas_mix = "o2=21.78;n2=82.36;TEMP=275"
	},
/area/hilbertshotel)
"lh" = (
/obj/effect/turf_decal/siding/wood{
	dir = 8
	},
/obj/structure/chair/sofa/middle/brown{
	dir = 4
	},
/turf/open/floor/carpet/royalblack,
/area/hilbertshotel)
"lj" = (
/obj/effect/turf_decal/siding/wood,
/obj/structure/chair/sofa/right/brown{
	dir = 1
	},
/turf/open/floor/carpet/royalblack,
/area/hilbertshotel)
"lp" = (
/obj/effect/turf_decal/siding/wood{
	dir = 6
	},
/obj/structure/bed/double,
/obj/item/bedsheet/random/double,
/turf/open/floor/carpet/royalblue,
/area/hilbertshotel)
"lC" = (
/obj/structure/closet/crate/freezer,
/obj/item/reagent_containers/food/drinks/beer,
/obj/item/reagent_containers/food/drinks/beer,
/obj/item/reagent_containers/food/drinks/beer,
/obj/item/reagent_containers/food/drinks/beer,
/obj/item/reagent_containers/food/drinks/beer,
/obj/effect/turf_decal/siding/wood{
	dir = 6
	},
/turf/open/floor/wood/wood_tiled,
/area/hilbertshotel)
"lT" = (
/obj/structure/window/reinforced,
/obj/structure/table/wood,
/obj/structure/curtain/goliath,
/turf/open/floor/wood/wood_tiled,
/area/hilbertshotel)
"mz" = (
/obj/effect/turf_decal/siding/wood,
/turf/open/floor/carpet/royalblue,
/area/hilbertshotel)
"nb" = (
/obj/structure/flora/tree/pine,
/turf/open/floor/plating/asteroid/snow{
	initial_gas_mix = "o2=21.78;n2=82.36;TEMP=275"
	},
/area/hilbertshotel)
"nk" = (
/obj/effect/turf_decal/siding/wood{
	dir = 1
	},
/obj/machinery/light_switch/directional/north,
/turf/open/floor/wood/wood_tiled,
/area/hilbertshotel)
"nH" = (
/obj/structure/fans/tiny/invisible,
/obj/effect/turf_decal/siding/wood/end{
	dir = 4
	},
/obj/structure/mineral_door/wood,
/turf/open/floor/wood/wood_tiled,
/area/hilbertshotel)
"nY" = (
/obj/structure/chair/pew/left{
	dir = 4
	},
/obj/effect/turf_decal/siding/wood{
	dir = 8
	},
/turf/open/floor/wood/wood_tiled,
/area/hilbertshotel)
"oF" = (
/obj/effect/turf_decal/siding/wood{
	dir = 6
	},
/obj/structure/closet/cabinet,
/obj/item/clothing/shoes/winterboots{
	pixel_x = 2;
	pixel_y = -2
	},
/obj/item/clothing/shoes/winterboots{
	pixel_x = 2;
	pixel_y = -2
	},
/obj/item/clothing/suit/hooded/wintercoat,
/obj/item/clothing/suit/hooded/wintercoat,
/turf/open/floor/wood/wood_tiled,
/area/hilbertshotel)
"pd" = (
/obj/structure/chair/wood{
	dir = 8
	},
/turf/open/floor/plating/asteroid/snow{
	initial_gas_mix = "o2=21.78;n2=82.36;TEMP=275"
	},
/area/hilbertshotel)
"pH" = (
/obj/effect/turf_decal/siding/wood{
	dir = 6
	},
/turf/open/floor/carpet/royalblack,
/area/hilbertshotel)
"pM" = (
/obj/effect/turf_decal/siding/wood{
	dir = 1
	},
/turf/open/floor/wood/wood_tiled,
/area/hilbertshotel)
"pO" = (
/obj/effect/turf_decal/siding/wood{
	dir = 9
	},
/obj/machinery/computer{
	dir = 4;
	pixel_x = -3
	},
/turf/open/floor/carpet/royalblue,
/area/hilbertshotel)
"pR" = (
/obj/structure/chair/pew,
/obj/effect/turf_decal/siding/wood{
	dir = 1
	},
/obj/machinery/light{
	dir = 1
	},
/turf/open/floor/wood/wood_tiled,
/area/hilbertshotel)
"rA" = (
/obj/effect/turf_decal/siding/wood{
	dir = 5
	},
/turf/open/floor/carpet,
/area/hilbertshotel)
"rE" = (
/obj/effect/turf_decal/siding/wood{
	dir = 10
	},
/obj/structure/closet/cabinet,
/obj/item/clothing/shoes/sandal,
/obj/item/clothing/shoes/sandal,
/obj/item/clothing/under/misc/bathrobe,
/obj/item/clothing/under/misc/bathrobe,
/turf/open/floor/carpet/royalblue,
/area/hilbertshotel)
"sx" = (
/obj/structure/flora/grass/both,
/turf/open/floor/plating/asteroid/snow{
	initial_gas_mix = "o2=21.78;n2=82.36;TEMP=275"
	},
/area/hilbertshotel)
"sS" = (
/obj/structure/chair/pew/right,
/turf/open/floor/plating/asteroid/snow{
	initial_gas_mix = "o2=21.78;n2=82.36;TEMP=275"
	},
/area/hilbertshotel)
"tg" = (
/obj/structure/sink{
	dir = 4;
	pixel_x = 14
	},
/obj/structure/mirror{
	pixel_x = 32
	},
/turf/open/indestructible/hoteltile,
/area/hilbertshotel)
"tX" = (
/obj/effect/turf_decal/siding/wood{
	dir = 4
	},
/obj/machinery/light_switch/directional/east,
/turf/open/floor/wood/wood_tiled,
/area/hilbertshotel)
"uz" = (
/obj/structure/sink/kitchen{
	dir = 4;
	pixel_x = -14
	},
/turf/open/floor/plasteel/cafeteria,
/area/hilbertshotel)
"uD" = (
/obj/effect/turf_decal/siding/wood/corner,
/obj/effect/turf_decal/siding/wood/corner{
	dir = 8
	},
/turf/open/floor/carpet/royalblue,
/area/hilbertshotel)
"vx" = (
/obj/effect/turf_decal/siding/wood{
	dir = 1
	},
/obj/structure/chair/sofa/left/brown,
/turf/open/floor/carpet/royalblack,
/area/hilbertshotel)
"we" = (
/obj/structure/chair/wood,
/turf/open/floor/plating/asteroid/snow{
	initial_gas_mix = "o2=21.78;n2=82.36;TEMP=275"
	},
/area/hilbertshotel)
"xr" = (
/obj/structure/sauna_oven,
/obj/effect/turf_decal/siding/wood{
	dir = 10
	},
/turf/open/floor/wood/wood_tiled,
/area/hilbertshotel)
"xv" = (
/turf/open/floor/plating/asteroid/snow{
	initial_gas_mix = "o2=21.78;n2=82.36;TEMP=275"
	},
/area/hilbertshotel)
"xJ" = (
/obj/effect/turf_decal/siding/wood{
	dir = 4
	},
/turf/open/floor/carpet/royalblack,
/area/hilbertshotel)
"xQ" = (
/obj/effect/turf_decal/siding/wood{
	dir = 1
	},
/obj/machinery/light{
	dir = 1
	},
/obj/structure/sign/poster/official/the_owl{
	pixel_y = 32
	},
/turf/open/floor/wood/wood_tiled,
/area/hilbertshotel)
"yr" = (
/obj/structure/flora/tree/pine,
/turf/closed/indestructible/rock/snow,
/area/hilbertshotel)
"yD" = (
/turf/open/floor/plasteel/cafeteria,
/area/hilbertshotel)
"yU" = (
/turf/open/floor/plating/snowed/smoothed{
	initial_gas_mix = "o2=21.78;n2=82.36;TEMP=275"
	},
/area/hilbertshotel)
"yV" = (
/obj/machinery/door/window/southright{
	dir = 4
	},
/turf/open/floor/plasteel/cafeteria,
/area/hilbertshotel)
"zU" = (
/obj/machinery/vending/dinnerware{
	contraband = list(/obj/item/kitchen/rollingpin=2,/obj/item/kitchen/knife/butcher=2,/obj/item/reagent_containers/food/condiment/flour=4);
	shut_up = 1
	},
/turf/closed/indestructible/wood,
/area/hilbertshotel)
"Ah" = (
/obj/effect/turf_decal/siding/wood{
	dir = 9
	},
/turf/open/floor/wood/wood_tiled,
/area/hilbertshotel)
"As" = (
/obj/effect/turf_decal/siding/wood{
	dir = 10
	},
/obj/structure/closet/cabinet,
/obj/item/clothing/shoes/winterboots{
	pixel_x = 2;
	pixel_y = -2
	},
/obj/item/clothing/shoes/winterboots{
	pixel_x = 2;
	pixel_y = -2
	},
/obj/item/clothing/suit/hooded/wintercoat,
/obj/item/clothing/suit/hooded/wintercoat,
/turf/open/floor/wood/wood_tiled,
/area/hilbertshotel)
"BZ" = (
/turf/closed/indestructible/wood,
/area/hilbertshotel)
"CC" = (
/obj/effect/turf_decal/siding/wood{
	dir = 8
	},
/obj/machinery/light/small{
	brightness = 3;
	dir = 8
	},
/turf/open/floor/carpet,
/area/hilbertshotel)
"CR" = (
/obj/effect/turf_decal/siding/wood{
	dir = 6
	},
/obj/machinery/vending/cigarette{
	shut_up = 1
	},
/turf/open/floor/carpet,
/area/hilbertshotel)
"Dc" = (
/obj/effect/turf_decal/siding/wood{
	dir = 4
	},
/obj/structure/fireplace{
	dir = 8
	},
/turf/open/floor/wood/wood_tiled,
/area/hilbertshotel)
"De" = (
/obj/machinery/light/small{
	dir = 1
	},
/turf/open/floor/plating/asteroid/snow{
	initial_gas_mix = "o2=21.78;n2=82.36;TEMP=275"
	},
/area/hilbertshotel)
"Dl" = (
/turf/closed/indestructible/hoteldoor{
	icon_state = "door_closed";
	icon = 'icons/obj/doors/puzzledoor/default.dmi'
	},
/area/hilbertshotel)
"Dx" = (
/turf/closed/indestructible/rock/snow,
/area/hilbertshotel)
"DA" = (
/obj/structure/bonfire,
/turf/open/floor/plating/asteroid/snow{
	initial_gas_mix = "o2=21.78;n2=82.36;TEMP=275"
	},
/area/hilbertshotel)
"DX" = (
/obj/machinery/vending/coffee{
	shut_up = 1
	},
/turf/closed/indestructible/wood,
/area/hilbertshotel)
"Eg" = (
/obj/effect/turf_decal/siding/wood/corner{
	dir = 4
	},
/obj/effect/turf_decal/siding/wood/corner,
/turf/open/floor/wood/wood_tiled,
/area/hilbertshotel)
"Ew" = (
/obj/structure/chair/pew/left,
/turf/open/floor/plating/asteroid/snow{
	initial_gas_mix = "o2=21.78;n2=82.36;TEMP=275"
	},
/area/hilbertshotel)
"Ex" = (
/obj/structure/table/wood,
/obj/structure/bedsheetbin/towel,
/obj/effect/turf_decal/siding/wood{
	dir = 6
	},
/turf/open/floor/wood/wood_tiled,
/area/hilbertshotel)
"Fs" = (
/obj/structure/flora/tree/dead,
/turf/closed/indestructible/rock/snow,
/area/hilbertshotel)
"Fu" = (
/obj/effect/turf_decal/siding/wood{
	dir = 8
	},
/obj/effect/turf_decal/siding/wood/corner{
	dir = 4
	},
/turf/open/floor/wood/wood_tiled,
/area/hilbertshotel)
"GU" = (
/obj/effect/turf_decal/siding/wood{
	dir = 5
	},
/turf/open/floor/carpet/royalblack,
/area/hilbertshotel)
"Hw" = (
/obj/structure/fans/tiny/invisible,
/obj/effect/turf_decal/siding/wood,
/obj/effect/turf_decal/siding/wood{
	dir = 1
	},
/obj/structure/mineral_door/woodrustic,
/turf/open/floor/wood/wood_tiled,
/area/hilbertshotel)
"HM" = (
/obj/structure/chair/pew/left,
/obj/effect/turf_decal/siding/wood{
	dir = 1
	},
/turf/open/floor/wood/wood_tiled,
/area/hilbertshotel)
"HN" = (
/obj/effect/turf_decal/siding/wood{
	dir = 8
	},
/obj/effect/turf_decal/siding/wood{
	dir = 4
	},
/obj/structure/mineral_door/wood,
/turf/open/floor/wood/wood_tiled,
/area/hilbertshotel)
"Iy" = (
/obj/effect/turf_decal/siding/wood{
	dir = 1
	},
/obj/structure/chair/office/dark{
	dir = 8
	},
/obj/structure/sign/poster/contraband/yes_erp{
	pixel_y = 32
	},
/turf/open/floor/carpet/royalblue,
/area/hilbertshotel)
"JC" = (
/obj/structure/table/wood/fancy,
/obj/item/candle/infinite{
	pixel_y = 7
	},
/turf/open/floor/carpet/royalblack,
/area/hilbertshotel)
"JY" = (
/obj/effect/turf_decal/siding/wood{
	dir = 9
	},
/obj/structure/closet/cabinet{
	pixel_x = -6
	},
/turf/open/floor/wood/wood_tiled,
/area/hilbertshotel)
"Ld" = (
/obj/effect/turf_decal/siding/wood{
	dir = 10
	},
/obj/machinery/vending/kink{
	shut_up = 1
	},
/turf/open/floor/carpet,
/area/hilbertshotel)
"LH" = (
/obj/effect/turf_decal/siding/wood{
	dir = 10
	},
/obj/structure/chair/sofa/corner/brown{
	dir = 1
	},
/turf/open/floor/carpet/royalblack,
/area/hilbertshotel)
"Mt" = (
/obj/effect/turf_decal/siding/wood/corner{
	dir = 1
	},
/turf/open/floor/wood/wood_tiled,
/area/hilbertshotel)
"MC" = (
/obj/effect/turf_decal/siding/wood/corner{
	dir = 8
	},
/obj/effect/turf_decal/siding/wood/corner,
/turf/open/floor/carpet/royalblue,
/area/hilbertshotel)
"Ng" = (
/obj/structure/table/reinforced,
/obj/machinery/reagentgrinder{
	pixel_y = 8
	},
/turf/open/floor/plasteel/cafeteria,
/area/hilbertshotel)
"Nl" = (
/obj/structure/reagent_dispensers/watertank,
/obj/effect/turf_decal/siding/wood{
	dir = 9
	},
/turf/open/floor/wood/wood_tiled,
/area/hilbertshotel)
"Og" = (
/obj/structure/flora/grass/brown,
/turf/open/floor/plating/asteroid/snow{
	initial_gas_mix = "o2=21.78;n2=82.36;TEMP=275"
	},
/area/hilbertshotel)
"Oh" = (
/obj/structure/table/reinforced,
/obj/item/reagent_containers/food/condiment/saltshaker{
	pixel_y = 9;
	pixel_x = 10
	},
/obj/item/reagent_containers/food/condiment/peppermill{
	pixel_x = 10
	},
/obj/item/sharpener{
	pixel_x = -5
	},
/turf/open/floor/plasteel/cafeteria,
/area/hilbertshotel)
"Pm" = (
/obj/effect/turf_decal/siding/wood/corner{
	dir = 8
	},
/obj/effect/turf_decal/siding/wood/corner{
	dir = 1
	},
/turf/open/floor/wood/wood_tiled,
/area/hilbertshotel)
"Po" = (
/obj/effect/turf_decal/siding/wood,
/obj/machinery/light,
/turf/open/floor/wood/wood_tiled,
/area/hilbertshotel)
"Px" = (
/obj/effect/turf_decal/siding/wood{
	dir = 9
	},
/obj/structure/chair/sofa/corner/brown{
	dir = 4
	},
/turf/open/floor/carpet/royalblack,
/area/hilbertshotel)
"PZ" = (
/obj/structure/flora/grass/brown,
/obj/machinery/light/small{
	brightness = 3;
	dir = 8
	},
/obj/machinery/light/small,
/turf/open/floor/plating/asteroid/snow{
	initial_gas_mix = "o2=21.78;n2=82.36;TEMP=275"
	},
/area/hilbertshotel)
"Qp" = (
/obj/structure/table/wood,
/obj/effect/turf_decal/siding/wood{
	dir = 5
	},
/turf/open/floor/wood/wood_tiled,
/area/hilbertshotel)
"Qt" = (
/obj/effect/turf_decal/siding/wood{
	dir = 9
	},
/obj/structure/table/wood,
/obj/structure/reagent_dispensers/keg/mead,
/turf/open/floor/carpet,
/area/hilbertshotel)
"QO" = (
/obj/structure/chair/wood{
	dir = 4
	},
/turf/open/floor/plating/asteroid/snow{
	initial_gas_mix = "o2=21.78;n2=82.36;TEMP=275"
	},
/area/hilbertshotel)
"QR" = (
/obj/effect/turf_decal/siding/wood{
	dir = 1
	},
/obj/structure/dresser,
/turf/open/floor/carpet/royalblue,
/area/hilbertshotel)
"RQ" = (
/obj/structure/bookcase/random/nonfiction,
/turf/closed/indestructible/wood,
/area/hilbertshotel)
"RW" = (
/obj/structure/chair/pew/right,
/obj/effect/turf_decal/siding/wood{
	dir = 1
	},
/turf/open/floor/wood/wood_tiled,
/area/hilbertshotel)
"Su" = (
/obj/structure/closet/crate/wooden,
/obj/item/stack/sheet/mineral/wood/fifty,
/obj/item/reagent_containers/glass/bucket{
	pixel_y = 7
	},
/obj/effect/turf_decal/siding/wood{
	dir = 4
	},
/turf/open/floor/wood/wood_tiled,
/area/hilbertshotel)
"Sy" = (
/obj/structure/flora/grass/green,
/obj/machinery/light/small,
/turf/open/floor/plating/asteroid/snow{
	initial_gas_mix = "o2=21.78;n2=82.36;TEMP=275"
	},
/area/hilbertshotel)
"Tp" = (
/obj/effect/turf_decal/siding/wood{
	dir = 1
	},
/obj/item/kirbyplants/random,
/turf/open/floor/carpet/royalblue,
/area/hilbertshotel)
"Ty" = (
/obj/machinery/vending/boozeomat,
/turf/closed/indestructible/wood,
/area/hilbertshotel)
"TO" = (
/obj/structure/toilet{
	dir = 4
	},
/turf/open/indestructible/hoteltile,
/area/hilbertshotel)
"TX" = (
/obj/structure/chair/pew,
/obj/machinery/light/floor{
	light_color = "#f27d0c";
	color = "FFB43A"
	},
/turf/open/floor/plating/asteroid/snow{
	initial_gas_mix = "o2=21.78;n2=82.36;TEMP=275"
	},
/area/hilbertshotel)
"Uq" = (
/obj/structure/mineral_door/paperframe,
/area/hilbertshotel)
"Ur" = (
/obj/structure/window/reinforced/tinted,
/obj/machinery/door/window/eastright,
/obj/machinery/shower{
	desc = "Despite their age, they seem clean and capable of providing hot water just as well as their modern counterparts. Hopefully Nanotrasen cleaned the water pipes this well...";
	dir = 4
	},
/obj/item/soap/deluxe,
/turf/open/indestructible/hoteltile,
/area/hilbertshotel)
"Vt" = (
/turf/open/floor/wood/wood_large,
/area/hilbertshotel)
"We" = (
/obj/effect/turf_decal/siding/wood/corner,
/obj/effect/turf_decal/siding/wood/corner{
	dir = 4
	},
/turf/open/floor/wood/wood_tiled,
/area/hilbertshotel)
"Wx" = (
/obj/effect/turf_decal/siding/wood{
	dir = 4
	},
/obj/effect/turf_decal/siding/wood/corner{
	dir = 1
	},
/turf/open/floor/wood/wood_tiled,
/area/hilbertshotel)
"WD" = (
/obj/machinery/light/small{
	dir = 4
	},
/turf/open/indestructible/hoteltile,
/area/hilbertshotel)
"WR" = (
/obj/structure/window/reinforced,
/obj/structure/table/wood,
/obj/item/flashlight/lamp/green,
/obj/structure/curtain/goliath,
/turf/open/floor/wood/wood_tiled,
/area/hilbertshotel)
"WS" = (
/obj/structure/flora/grass/both,
/obj/machinery/light/small{
	brightness = 3;
	dir = 8
	},
/turf/open/floor/plating/asteroid/snow{
	initial_gas_mix = "o2=21.78;n2=82.36;TEMP=275"
	},
/area/hilbertshotel)
"XA" = (
/obj/structure/closet/crate/bin{
	pixel_x = -6
	},
/obj/machinery/light{
	dir = 8
	},
/turf/open/floor/plasteel/cafeteria,
/area/hilbertshotel)
"Yd" = (
/obj/structure/bookcase/random/reference,
/turf/closed/indestructible/wood,
/area/hilbertshotel)
"YF" = (
/obj/effect/turf_decal/siding/wood{
	dir = 4
	},
/obj/machinery/light/small{
	dir = 4
	},
/obj/machinery/light_switch/directional/east,
/turf/open/floor/wood/wood_tiled,
/area/hilbertshotel)
"YH" = (
/obj/effect/turf_decal/siding/wood{
	dir = 4
	},
/obj/machinery/light{
	dir = 4
	},
/turf/open/floor/wood/wood_tiled,
/area/hilbertshotel)
"Zs" = (
/obj/structure/table/wood,
/obj/effect/turf_decal/siding/wood{
	dir = 10
	},
/obj/item/instrument/guitar,
/turf/open/floor/wood/wood_tiled,
/area/hilbertshotel)

(1,1,1) = {"
BZ
BZ
BZ
BZ
BZ
BZ
BZ
BZ
BZ
BZ
BZ
BZ
BZ
BZ
BZ
BZ
"}
(2,1,1) = {"
BZ
pO
rE
BZ
Ur
TO
BZ
Qt
CC
Ld
BZ
Nl
cC
nY
xr
BZ
"}
(3,1,1) = {"
BZ
Iy
MC
Uq
WD
tg
BZ
rA
ag
CR
BZ
HM
Vt
Vt
dl
BZ
"}
(4,1,1) = {"
BZ
Tp
mz
BZ
BZ
BZ
BZ
BZ
hD
BZ
BZ
pR
Vt
Vt
Po
BZ
"}
(5,1,1) = {"
BZ
QR
uD
HN
Fu
hA
HN
Fu
Pm
As
BZ
RW
Vt
Vt
dl
BZ
"}
(6,1,1) = {"
BZ
aP
lp
BZ
xQ
dl
BZ
cI
We
oF
BZ
Qp
Su
Eg
lC
BZ
"}
(7,1,1) = {"
BZ
BZ
BZ
BZ
nk
dl
BZ
BZ
nH
BZ
BZ
BZ
BZ
Hw
BZ
BZ
"}
(8,1,1) = {"
zU
uz
XA
cN
pM
dl
BZ
WS
yU
PZ
BZ
JY
kS
iB
Zs
BZ
"}
(9,1,1) = {"
Ty
yD
yD
Oh
pM
Po
BZ
De
yU
yU
iJ
Wx
tX
YH
Ex
BZ
"}
(10,1,1) = {"
DX
yV
Ng
kf
pM
dl
WR
Ew
yU
Sy
BZ
BZ
BZ
BZ
BZ
BZ
"}
(11,1,1) = {"
gX
Ah
aO
aO
Mt
dl
lT
TX
yU
xv
Og
fN
xv
sx
xv
yr
"}
(12,1,1) = {"
RQ
pM
Px
lh
LH
dl
lT
sS
yU
yU
yU
yU
yU
yU
yU
Dl
"}
(13,1,1) = {"
Yd
pM
vx
JC
lj
Po
BZ
kY
xv
fN
sx
QO
fN
xv
xv
yr
"}
(14,1,1) = {"
jc
pM
GU
xJ
pH
dl
BZ
xv
nb
xv
we
DA
gq
Og
xv
Fs
"}
(15,1,1) = {"
BZ
eS
YF
Dc
br
bH
BZ
xv
Og
sx
Og
pd
xv
xv
yr
Dx
"}
(16,1,1) = {"
BZ
BZ
BZ
BZ
BZ
BZ
BZ
Dx
yr
Dx
Fs
Dx
Dx
yr
Dx
jw
"}
