//MAP CONVERTED BY dmm2tgm.py THIS HEADER COMMENT PREVENTS RECONVERSION, DO NOT REMOVE
"aa" = (
/turf/open/space/bluespace,
/area/hilbertshotel)
"ab" = (
/obj/machinery/telecomms/relay/preset/auto,
/turf/open/floor/catwalk_floor,
/area/hilbertshotel)
"ag" = (
/obj/effect/turf_decal/siding/wood{
	dir = 8
	},
/turf/open/floor/wood/wood_tiled,
/area/hilbertshotel)
"aj" = (
/turf/open/floor/catwalk_floor,
/area/hilbertshotel)
"am" = (
/obj/machinery/vending/kink{
	shut_up = 1
	},
/turf/open/indestructible/hotelwood,
/area/hilbertshotel)
"an" = (
/obj/machinery/door/morgue,
/turf/open/indestructible/hotelwood,
/area/hilbertshotel)
"aq" = (
/obj/structure/dresser,
/turf/open/floor/carpet,
/area/hilbertshotel)
"ar" = (
/obj/machinery/light/small{
	dir = 1
	},
/obj/structure/closet/cabinet{
	anchored = 1
	},
/turf/open/floor/carpet,
/area/hilbertshotel)
"at" = (
/turf/closed/indestructible/hoteldoor{
	icon_state = "door_closed";
	icon = 'icons/obj/doors/puzzledoor/default.dmi'
	},
/area/hilbertshotel)
"ax" = (
/turf/open/floor/carpet,
/area/hilbertshotel)
"az" = (
/obj/effect/turf_decal/siding/thinplating/dark/corner{
	dir = 4
	},
/turf/open/floor/mineral/plastitanium,
/area/hilbertshotel)
"aB" = (
/obj/machinery/light/small{
	dir = 8
	},
/turf/open/indestructible/hoteltile,
/area/hilbertshotel)
"aC" = (
/obj/structure/window/reinforced/tinted,
/obj/structure/toilet{
	dir = 8
	},
/obj/machinery/door/window/westleft,
/turf/open/indestructible/hoteltile,
/area/hilbertshotel)
"aD" = (
/obj/effect/turf_decal/siding/wood,
/obj/structure/closet/crate/bin,
/turf/open/floor/wood/wood_tiled,
/area/hilbertshotel)
"aF" = (
/obj/structure/bed/double,
/obj/item/bedsheet/random/double,
/turf/open/floor/carpet,
/area/hilbertshotel)
"aI" = (
/obj/structure/mirror{
	pixel_x = -32
	},
/obj/structure/sink{
	dir = 8;
	pixel_x = -12;
	pixel_y = 2
	},
/turf/open/indestructible/hoteltile,
/area/hilbertshotel)
"aJ" = (
/turf/open/indestructible/hoteltile,
/area/hilbertshotel)
"aK" = (
/obj/structure/mineral_door/paperframe,
/turf/open/indestructible/hoteltile,
/area/hilbertshotel)
"aL" = (
/obj/effect/turf_decal/siding/wood{
	dir = 1
	},
/obj/structure/window/reinforced/tinted{
	dir = 1
	},
/turf/open/indestructible/hotelwood,
/area/hilbertshotel)
"aO" = (
/obj/effect/turf_decal/siding/wood/corner{
	dir = 8
	},
/turf/open/indestructible/hotelwood,
/area/hilbertshotel)
"aP" = (
/obj/effect/turf_decal/siding/wood/corner,
/turf/open/indestructible/hotelwood,
/area/hilbertshotel)
"aQ" = (
/obj/machinery/light/small,
/obj/structure/table/wood/fancy,
/obj/item/toy/plush/beeplushie,
/turf/open/indestructible/hotelwood,
/area/hilbertshotel)
"aT" = (
/turf/open/floor/plasteel/stairs/right,
/area/hilbertshotel)
"aU" = (
/turf/open/floor/plasteel/stairs/left,
/area/hilbertshotel)
"aV" = (
/turf/open/floor/mineral/plastitanium/red,
/area/hilbertshotel)
"aW" = (
/turf/open/floor/plasteel/stairs/right{
	dir = 8
	},
/area/hilbertshotel)
"aX" = (
/obj/effect/turf_decal/siding/wood/corner{
	dir = 4
	},
/turf/open/floor/wood/wood_tiled,
/area/hilbertshotel)
"aZ" = (
/obj/effect/turf_decal/siding/thinplating/dark,
/turf/open/floor/mineral/plastitanium,
/area/hilbertshotel)
"bc" = (
/turf/open/floor/plasteel/stairs/left{
	dir = 8
	},
/area/hilbertshotel)
"bg" = (
/obj/structure/chair/sofa/middle/maroon,
/turf/open/floor/carpet,
/area/hilbertshotel)
"bh" = (
/obj/structure/chair/sofa/left/maroon,
/turf/open/floor/carpet,
/area/hilbertshotel)
"bk" = (
/obj/structure/chair/sofa/left/maroon{
	dir = 4
	},
/turf/open/floor/carpet,
/area/hilbertshotel)
"bl" = (
/obj/structure/table/wood,
/turf/open/floor/carpet,
/area/hilbertshotel)
"bn" = (
/obj/structure/chair/sofa/right/maroon{
	dir = 8
	},
/turf/open/floor/carpet,
/area/hilbertshotel)
"bp" = (
/obj/structure/table/reinforced,
/obj/machinery/microwave,
/turf/open/floor/plasteel/cafeteria,
/area/hilbertshotel)
"bq" = (
/obj/machinery/vending/boozeomat{
	shut_up = 1
	},
/turf/open/floor/plasteel/cafeteria,
/area/hilbertshotel)
"bs" = (
/obj/structure/table/reinforced,
/obj/machinery/light{
	dir = 1;
	light_color = "#cee5d2"
	},
/obj/item/reagent_containers/food/drinks/bottle/champagne,
/turf/open/floor/plasteel/cafeteria,
/area/hilbertshotel)
"bu" = (
/obj/structure/chair/sofa/right/maroon{
	dir = 4
	},
/turf/open/floor/carpet,
/area/hilbertshotel)
"bv" = (
/obj/structure/chair/sofa/left/maroon{
	dir = 8
	},
/turf/open/floor/carpet,
/area/hilbertshotel)
"bw" = (
/obj/structure/table/reinforced,
/obj/structure/sink/kitchen,
/turf/open/floor/plasteel/cafeteria,
/area/hilbertshotel)
"bx" = (
/turf/open/floor/plasteel/cafeteria,
/area/hilbertshotel)
"by" = (
/obj/structure/table/reinforced,
/obj/item/reagent_containers/food/drinks/drinkingglass{
	pixel_x = 5;
	pixel_y = 4
	},
/obj/item/reagent_containers/food/drinks/drinkingglass,
/obj/item/reagent_containers/food/drinks/drinkingglass{
	pixel_x = -5;
	pixel_y = 5
	},
/turf/open/floor/plasteel/cafeteria,
/area/hilbertshotel)
"bz" = (
/obj/structure/closet/secure_closet/freezer/fridge,
/obj/item/reagent_containers/food/condiment/sugar,
/obj/item/reagent_containers/food/condiment/flour,
/obj/item/reagent_containers/food/drinks/beer,
/obj/item/reagent_containers/food/drinks/beer,
/obj/item/reagent_containers/food/drinks/beer,
/obj/item/reagent_containers/food/drinks/beer,
/obj/item/reagent_containers/food/drinks/beer,
/obj/item/reagent_containers/food/drinks/beer,
/obj/item/reagent_containers/food/condiment/rice,
/turf/open/floor/plasteel/cafeteria,
/area/hilbertshotel)
"bA" = (
/obj/machinery/jukebox{
	req_one_access = null;
	area_limited = 1
	},
/obj/effect/turf_decal/siding/wood,
/turf/open/floor/wood/wood_tiled,
/area/hilbertshotel)
"bC" = (
/obj/item/kirbyplants/random,
/obj/effect/turf_decal/siding/wood{
	dir = 6
	},
/turf/open/floor/wood/wood_tiled,
/area/hilbertshotel)
"cA" = (
/obj/effect/turf_decal/siding/wood{
	dir = 4
	},
/obj/structure/window{
	dir = 8
	},
/obj/structure/flora/junglebush,
/obj/structure/flora/junglebush/large,
/turf/open/floor/grass/grass0,
/area/hilbertshotel)
"dh" = (
/obj/structure/table/wood,
/obj/structure/showcase/machinery/tv,
/turf/open/floor/carpet,
/area/hilbertshotel)
"dC" = (
/obj/machinery/vending/games{
	shut_up = 1
	},
/obj/effect/turf_decal/siding/wood,
/turf/open/floor/wood/wood_tiled,
/area/hilbertshotel)
"dT" = (
/obj/effect/turf_decal/siding/wood{
	dir = 10
	},
/turf/open/floor/wood/wood_tiled,
/area/hilbertshotel)
"dU" = (
/obj/machinery/light{
	dir = 4
	},
/obj/effect/turf_decal/siding/wood{
	dir = 4
	},
/obj/structure/window{
	dir = 8
	},
/obj/structure/flora/junglebush,
/turf/open/floor/grass/grass0,
/area/hilbertshotel)
"gc" = (
/obj/effect/turf_decal/siding/wood{
	dir = 4
	},
/obj/structure/window{
	dir = 8
	},
/obj/structure/window{
	dir = 1
	},
/obj/structure/flora/junglebush,
/obj/structure/flora/junglebush/large,
/turf/open/floor/grass/grass0,
/area/hilbertshotel)
"kt" = (
/obj/structure/table/wood,
/obj/item/storage/fancy/candle_box{
	pixel_x = 4
	},
/obj/item/storage/fancy/candle_box{
	pixel_x = -8
	},
/turf/open/floor/carpet,
/area/hilbertshotel)
"kR" = (
/obj/machinery/door/window/survival_pod{
	dir = 4
	},
/turf/open/floor/plasteel/cafeteria,
/area/hilbertshotel)
"kT" = (
/obj/effect/turf_decal/siding/wood{
	dir = 4
	},
/obj/effect/turf_decal/siding/wood{
	dir = 8
	},
/turf/open/indestructible/hotelwood,
/area/hilbertshotel)
"lm" = (
/obj/machinery/light/small,
/obj/item/kirbyplants/random,
/obj/effect/turf_decal/siding/wood{
	dir = 10
	},
/turf/open/indestructible/hotelwood,
/area/hilbertshotel)
"lo" = (
/obj/machinery/smartfridge/food,
/turf/closed/indestructible/wall,
/area/hilbertshotel)
"mf" = (
/obj/effect/turf_decal/siding/thinplating/dark{
	dir = 5
	},
/obj/structure/sign/poster/contraband/random{
	pixel_x = 32
	},
/turf/open/floor/mineral/plastitanium,
/area/hilbertshotel)
"nE" = (
/obj/effect/turf_decal/siding/wood/corner{
	dir = 4
	},
/obj/effect/turf_decal/siding/wood/corner{
	dir = 1
	},
/obj/effect/turf_decal/siding/wood/corner{
	dir = 8
	},
/turf/open/indestructible/hotelwood,
/area/hilbertshotel)
"oY" = (
/obj/effect/turf_decal/siding/thinplating/dark{
	dir = 9
	},
/turf/open/floor/mineral/plastitanium,
/area/hilbertshotel)
"qh" = (
/obj/effect/turf_decal/siding/wood{
	dir = 4
	},
/obj/structure/window{
	dir = 8
	},
/obj/structure/window,
/obj/structure/flora/junglebush,
/turf/open/floor/grass/grass0,
/area/hilbertshotel)
"wX" = (
/obj/structure/table/wood,
/obj/item/toy/cards/deck,
/turf/open/floor/carpet,
/area/hilbertshotel)
"xS" = (
/obj/structure/window/reinforced/tinted{
	dir = 1
	},
/obj/machinery/shower{
	dir = 8
	},
/obj/item/soap/deluxe,
/obj/machinery/door/window/westright,
/turf/open/indestructible/hoteltile,
/area/hilbertshotel)
"yI" = (
/obj/structure/table/reinforced,
/obj/effect/spawner/lootdrop/three_course_meal,
/turf/open/floor/plasteel/cafeteria,
/area/hilbertshotel)
"GL" = (
/obj/machinery/airalarm/all_access{
	dir = 4;
	pixel_x = -24
	},
/obj/effect/turf_decal/siding/thinplating/dark{
	dir = 8
	},
/turf/open/floor/mineral/plastitanium,
/area/hilbertshotel)
"GN" = (
/obj/structure/chair/stool/bar,
/obj/effect/turf_decal/siding/wood{
	dir = 8
	},
/turf/open/floor/wood/wood_tiled,
/area/hilbertshotel)
"IH" = (
/obj/structure/sign/poster/contraband/random,
/turf/closed/wall,
/area/hilbertshotel)
"Ka" = (
/obj/effect/turf_decal/siding/wood{
	dir = 1
	},
/turf/open/floor/wood/wood_tiled,
/area/hilbertshotel)
"KK" = (
/obj/machinery/light{
	dir = 8
	},
/obj/machinery/light_switch{
	pixel_x = -32
	},
/turf/open/floor/plasteel/stairs/medium,
/area/hilbertshotel)
"KM" = (
/obj/effect/turf_decal/siding/thinplating/dark{
	dir = 4
	},
/turf/open/floor/mineral/plastitanium,
/area/hilbertshotel)
"Lo" = (
/obj/effect/turf_decal/siding/wood{
	dir = 5
	},
/obj/structure/window/reinforced/tinted{
	dir = 1
	},
/turf/open/indestructible/hotelwood,
/area/hilbertshotel)
"LU" = (
/obj/structure/table/reinforced,
/obj/item/candle/infinite,
/obj/effect/turf_decal/siding/wood,
/turf/open/floor/wood/wood_tiled,
/area/hilbertshotel)
"Nv" = (
/obj/machinery/light/small{
	dir = 1
	},
/obj/effect/turf_decal/siding/wood{
	dir = 4
	},
/obj/effect/turf_decal/siding/wood{
	dir = 8
	},
/obj/effect/turf_decal/siding/wood{
	dir = 1
	},
/turf/open/indestructible/hotelwood,
/area/hilbertshotel)
"Oi" = (
/obj/machinery/light_switch/directional/east,
/turf/open/floor/carpet,
/area/hilbertshotel)
"PJ" = (
/obj/effect/turf_decal/siding/thinplating/dark{
	dir = 4
	},
/obj/structure/sign/poster/contraband/random{
	pixel_x = 32
	},
/turf/open/floor/mineral/plastitanium,
/area/hilbertshotel)
"Rh" = (
/obj/structure/table/wood,
/obj/item/pizzabox/margherita{
	pixel_y = 11
	},
/turf/open/floor/carpet,
/area/hilbertshotel)
"TK" = (
/turf/open/floor/plasteel/stairs/medium,
/area/hilbertshotel)
"Vu" = (
/obj/effect/turf_decal/siding/thinplating/dark{
	dir = 8
	},
/turf/open/floor/mineral/plastitanium,
/area/hilbertshotel)
"Xr" = (
/obj/structure/sign/poster/contraband/random,
/turf/closed/indestructible/wall,
/area/hilbertshotel)
"XP" = (
/turf/closed/indestructible/wall,
/area/hilbertshotel)
"XQ" = (
/obj/item/kirbyplants/random,
/obj/effect/turf_decal/siding/wood{
	dir = 5
	},
/turf/open/floor/wood/wood_tiled,
/area/hilbertshotel)
"Yf" = (
/obj/machinery/light_switch{
	pixel_x = -32
	},
/obj/effect/turf_decal/siding/wood{
	dir = 4
	},
/obj/effect/turf_decal/siding/wood{
	dir = 8
	},
/turf/open/indestructible/hotelwood,
/area/hilbertshotel)
"Yw" = (
/obj/structure/chair/sofa/right/maroon,
/obj/item/choice_beacon/box/plushie,
/turf/open/floor/carpet,
/area/hilbertshotel)
"YE" = (
/obj/effect/turf_decal/siding/wood/corner{
	dir = 1
	},
/turf/open/floor/wood/wood_tiled,
/area/hilbertshotel)
"YK" = (
/obj/effect/turf_decal/siding/wood/corner{
	dir = 8
	},
/turf/open/floor/wood/wood_tiled,
/area/hilbertshotel)
"Zq" = (
/obj/item/kirbyplants/random,
/obj/effect/turf_decal/siding/thinplating/dark{
	dir = 10
	},
/turf/open/floor/mineral/plastitanium,
/area/hilbertshotel)
"ZC" = (
/turf/closed/wall,
/area/hilbertshotel)

(1,1,1) = {"
aa
aa
aa
aa
aa
aa
aa
aa
aa
aa
aa
aa
aa
aa
aa
aa
"}
(2,1,1) = {"
aa
ab
aj
XP
XP
Xr
XP
XP
XP
XP
XP
XP
XP
XP
XP
aa
"}
(3,1,1) = {"
aa
aj
aj
XP
oY
Vu
Vu
KK
GL
Zq
ZC
bp
bw
bz
XP
aa
"}
(4,1,1) = {"
aa
aj
aj
at
aV
aV
aV
TK
aV
aZ
ZC
yI
bx
bx
lo
aa
"}
(5,1,1) = {"
aa
aj
aj
XP
mf
KM
PJ
TK
az
aZ
ZC
bq
bx
bx
XP
aa
"}
(6,1,1) = {"
aa
aj
aj
XP
ZC
ZC
ZC
ZC
aW
bc
ZC
bs
by
kR
XP
aa
"}
(7,1,1) = {"
aa
XP
XP
XP
aB
aI
aJ
ZC
Ka
YK
ag
GN
GN
dT
XP
aa
"}
(8,1,1) = {"
aa
XP
am
ZC
aC
aJ
xS
ZC
Ka
ax
bk
bu
ax
aD
XP
aa
"}
(9,1,1) = {"
aa
XP
an
ZC
ZC
aK
ZC
IH
Ka
Yw
wX
bl
ax
LU
XP
aa
"}
(10,1,1) = {"
aa
XP
Nv
Yf
kT
nE
lm
ZC
Ka
bg
Rh
dh
ax
bA
XP
aa
"}
(11,1,1) = {"
aa
XP
ax
ax
ax
aL
aO
aU
YE
bh
kt
bl
ax
LU
XP
aa
"}
(12,1,1) = {"
aa
XP
aq
ax
ax
aL
aP
aT
aX
ax
bn
bv
ax
dC
XP
aa
"}
(13,1,1) = {"
aa
XP
ar
Oi
aF
Lo
aQ
ZC
XQ
gc
dU
cA
qh
bC
XP
aa
"}
(14,1,1) = {"
aa
XP
XP
XP
XP
XP
XP
XP
XP
XP
XP
XP
XP
XP
XP
aa
"}
(15,1,1) = {"
aa
aa
aa
aa
aa
aa
aa
aa
aa
aa
aa
aa
aa
aa
aa
aa
"}
(16,1,1) = {"
aa
aa
aa
aa
aa
aa
aa
aa
aa
aa
aa
aa
aa
aa
aa
aa
"}
