//MAP CONVERTED BY dmm2tgm.py THIS HEADER COMMENT PREVENTS RECONVERSION, DO NOT REMOVE
"aA" = (
/obj/structure/flora/ausbushes/sparsegrass,
/obj/machinery/light/floor,
/obj/structure/flora/biolumi/flower,
/turf/open/floor/grass/grass0,
/area/hilbertshotel)
"eg" = (
/obj/structure/flora/ausbushes/sparsegrass,
/obj/machinery/atmospherics/pipe/simple/supply/hidden{
	dir = 4
	},
/obj/machinery/atmospherics/pipe/simple/scrubbers/hidden/layer3{
	dir = 5
	},
/obj/structure/flora/ausbushes/brflowers,
/obj/structure/flora/biolumi/flower,
/turf/open/floor/grass/grass0,
/area/hilbertshotel)
"fz" = (
/obj/machinery/telecomms/relay/preset/auto,
/turf/open/floor/catwalk_floor,
/area/hilbertshotel)
"gj" = (
/obj/structure/lattice,
/obj/machinery/atmospherics/components/unary/tank/air{
	dir = 8
	},
/turf/open/space/bluespace,
/area/hilbertshotel)
"gm" = (
/obj/structure/lattice,
/turf/open/space/bluespace,
/area/hilbertshotel)
"gK" = (
/obj/structure/flora/ausbushes/sparsegrass,
/obj/structure/flora/ausbushes/brflowers,
/obj/structure/flora/ausbushes/brflowers,
/obj/structure/flora/ausbushes/brflowers,
/turf/open/floor/grass/grass0,
/area/hilbertshotel)
"hd" = (
/obj/structure/flora/ausbushes/ppflowers,
/obj/structure/flora/ausbushes/ywflowers,
/turf/open/floor/grass/grass0,
/area/hilbertshotel)
"iy" = (
/obj/structure/flora/ausbushes/ywflowers,
/obj/structure/flora/ausbushes/ywflowers,
/obj/structure/flora/ausbushes/brflowers,
/obj/structure/flora/biolumi/lamp,
/turf/open/floor/grass/grass0,
/area/hilbertshotel)
"ji" = (
/obj/structure/flora/tree/spookylog,
/obj/structure/flora/ausbushes/sparsegrass,
/obj/structure/flora/ausbushes/ppflowers,
/obj/structure/flora/ausbushes/brflowers,
/turf/open/floor/grass/grass0,
/area/hilbertshotel)
"ka" = (
/obj/structure/flora/ausbushes/ywflowers,
/obj/structure/flora/ausbushes/ppflowers,
/obj/structure/flora/ausbushes/brflowers,
/turf/open/floor/grass/grass0,
/area/hilbertshotel)
"ko" = (
/obj/structure/flora/rock,
/obj/structure/flora/ausbushes/ywflowers,
/obj/structure/flora/ausbushes/brflowers,
/turf/open/floor/grass/grass0,
/area/hilbertshotel)
"kq" = (
/obj/structure/flora/ausbushes/sparsegrass,
/obj/structure/flora/ausbushes/ppflowers,
/obj/structure/flora/ausbushes/brflowers,
/obj/structure/flora/ausbushes/brflowers,
/turf/open/floor/grass/grass0,
/area/hilbertshotel)
"kP" = (
/obj/structure/flora/ausbushes/sparsegrass,
/obj/structure/flora/ausbushes/ywflowers,
/obj/structure/flora/biolumi/lamp,
/turf/open/floor/grass/grass0,
/area/hilbertshotel)
"lS" = (
/obj/structure/flora/tree/spookylog,
/obj/structure/flora/ausbushes/sparsegrass,
/obj/structure/flora/ausbushes/brflowers,
/obj/structure/flora/ausbushes/brflowers,
/turf/open/floor/grass/grass0,
/area/hilbertshotel)
"mO" = (
/obj/structure/flora/ausbushes/sparsegrass,
/obj/machinery/atmospherics/pipe/simple/supply/hidden{
	dir = 4
	},
/obj/structure/flora/ausbushes/brflowers,
/obj/structure/flora/biolumi,
/turf/open/floor/grass/grass0,
/area/hilbertshotel)
"mR" = (
/obj/structure/flora/ausbushes/sparsegrass,
/obj/machinery/light/floor,
/obj/structure/flora/ausbushes/brflowers,
/obj/structure/flora/ausbushes/brflowers,
/turf/open/floor/grass/grass0,
/area/hilbertshotel)
"om" = (
/obj/machinery/atmospherics/pipe/simple/supply/hidden,
/obj/item/candle/infinite,
/turf/open/floor/wood/wood_tiled,
/area/hilbertshotel)
"oy" = (
/obj/structure/flora/ausbushes/sparsegrass,
/obj/structure/flora/ausbushes/ppflowers,
/obj/structure/flora/ausbushes/ppflowers,
/turf/open/floor/grass/grass0,
/area/hilbertshotel)
"ph" = (
/obj/structure/flora/ausbushes/sparsegrass,
/obj/structure/flora/ausbushes/ppflowers,
/obj/structure/flora/ausbushes/brflowers,
/obj/structure/flora/biolumi/lamp,
/turf/open/floor/grass/grass0,
/area/hilbertshotel)
"qq" = (
/obj/structure/flora/ausbushes/sparsegrass,
/obj/structure/flora/ausbushes/ppflowers,
/turf/open/floor/grass/grass0,
/area/hilbertshotel)
"qX" = (
/obj/structure/flora/ausbushes/sparsegrass,
/obj/structure/flora/ausbushes/brflowers,
/obj/structure/flora/biolumi/flower,
/turf/open/floor/grass/grass0,
/area/hilbertshotel)
"rX" = (
/obj/structure/flora/ausbushes/lavendergrass,
/obj/structure/flora/ausbushes/ywflowers,
/obj/structure/flora/ausbushes/brflowers,
/turf/open/floor/grass/grass0,
/area/hilbertshotel)
"sg" = (
/obj/structure/flora/ausbushes/sparsegrass,
/obj/machinery/light/floor,
/obj/structure/flora/ausbushes/brflowers,
/turf/open/floor/grass/grass0,
/area/hilbertshotel)
"th" = (
/obj/structure/flora/tree/jungle{
	pixel_x = -31;
	pixel_y = 0
	},
/obj/structure/flora/ausbushes/sparsegrass,
/obj/structure/flora/ausbushes/ppflowers,
/turf/open/floor/grass/grass0,
/area/hilbertshotel)
"tu" = (
/obj/structure/flora/ausbushes/sparsegrass,
/obj/structure/flora/ausbushes/ywflowers,
/obj/structure/flora/ausbushes/brflowers,
/obj/structure/flora/ausbushes/brflowers,
/turf/open/floor/grass/grass0,
/area/hilbertshotel)
"tY" = (
/turf/open/floor/wood/wood_tiled,
/area/hilbertshotel)
"up" = (
/obj/structure/flora/ausbushes/ppflowers,
/obj/structure/flora/ausbushes/ppflowers,
/obj/structure/flora/ausbushes/brflowers,
/obj/structure/flora/ausbushes/brflowers,
/turf/open/floor/grass/grass0,
/area/hilbertshotel)
"uD" = (
/obj/structure/flora/ausbushes/sparsegrass,
/obj/machinery/atmospherics/pipe/simple/supply/hidden{
	dir = 4
	},
/obj/structure/flora/ausbushes/brflowers,
/turf/open/floor/grass/grass0,
/area/hilbertshotel)
"uP" = (
/obj/structure/lattice,
/obj/machinery/atmospherics/pipe/manifold/supply/hidden{
	dir = 4
	},
/obj/machinery/meter,
/turf/open/space/bluespace,
/area/hilbertshotel)
"vA" = (
/obj/structure/flora/ausbushes/sparsegrass,
/obj/structure/flora/ausbushes/brflowers,
/obj/structure/flora/ausbushes/brflowers,
/turf/open/floor/grass/grass0,
/area/hilbertshotel)
"vT" = (
/obj/structure/flora/ausbushes/ywflowers,
/obj/structure/flora/ausbushes/ppflowers,
/obj/structure/flora/ausbushes/brflowers,
/obj/structure/flora/ausbushes/brflowers,
/turf/open/floor/grass/grass0,
/area/hilbertshotel)
"wc" = (
/obj/structure/flora/rock,
/obj/machinery/atmospherics/components/unary/vent_scrubber/hilbertshotel/layer3,
/obj/structure/flora/ausbushes/brflowers,
/turf/open/floor/grass/grass0,
/area/hilbertshotel)
"wF" = (
/obj/structure/flora/ausbushes/ywflowers,
/obj/machinery/atmospherics/pipe/simple/supply/hidden{
	dir = 4
	},
/turf/open/floor/grass/grass0,
/area/hilbertshotel)
"wK" = (
/obj/structure/flora/ausbushes/ywflowers,
/obj/structure/flora/ausbushes/brflowers,
/turf/open/floor/grass/grass0,
/area/hilbertshotel)
"zi" = (
/obj/machinery/atmospherics/pipe/simple/supply/hidden,
/turf/open/floor/wood/wood_tiled,
/area/hilbertshotel)
"zn" = (
/turf/closed/indestructible/wood,
/area/hilbertshotel)
"Aq" = (
/obj/structure/flora/ausbushes/lavendergrass,
/obj/structure/flora/ausbushes/brflowers,
/turf/open/floor/grass/grass0,
/area/hilbertshotel)
"AB" = (
/obj/structure/flora/ausbushes/sparsegrass,
/obj/structure/flora/ausbushes/ppflowers,
/obj/structure/flora/ausbushes/brflowers,
/obj/structure/flora/ausbushes/brflowers,
/obj/structure/flora/biolumi/flower,
/turf/open/floor/grass/grass0,
/area/hilbertshotel)
"Cd" = (
/obj/structure/flora/ausbushes/sparsegrass,
/obj/structure/flora/ausbushes/ppflowers,
/obj/structure/flora/ausbushes/ppflowers,
/obj/structure/flora/ausbushes/ywflowers,
/turf/open/floor/grass/grass0,
/area/hilbertshotel)
"Cm" = (
/obj/structure/flora/ausbushes/ppflowers,
/obj/structure/flora/ausbushes/brflowers,
/turf/open/floor/grass/grass0,
/area/hilbertshotel)
"CE" = (
/obj/structure/flora/ausbushes/lavendergrass,
/obj/structure/flora/ausbushes/ywflowers,
/turf/open/floor/grass/grass0,
/area/hilbertshotel)
"CI" = (
/obj/structure/flora/ausbushes/sparsegrass,
/obj/machinery/atmospherics/pipe/simple/supply/hidden{
	dir = 5
	},
/obj/structure/flora/ausbushes/ppflowers,
/obj/structure/flora/ausbushes/brflowers,
/turf/open/floor/grass/grass0,
/area/hilbertshotel)
"DH" = (
/obj/structure/flora/ausbushes/sparsegrass,
/obj/structure/flora/ausbushes/brflowers,
/obj/structure/flora/ausbushes/brflowers,
/obj/structure/flora/biolumi,
/turf/open/floor/grass/grass0,
/area/hilbertshotel)
"DQ" = (
/obj/structure/flora/ausbushes/sparsegrass,
/obj/structure/flora/ausbushes/brflowers,
/obj/structure/flora/biolumi/lamp,
/turf/open/floor/grass/grass0,
/area/hilbertshotel)
"FO" = (
/obj/structure/lattice,
/obj/machinery/atmospherics/components/unary/outlet_injector/hilbertshotel/layer3{
	dir = 1
	},
/turf/open/space/bluespace,
/area/hilbertshotel)
"FZ" = (
/obj/structure/flora/ausbushes/sparsegrass,
/obj/structure/flora/biolumi/flower,
/turf/open/floor/grass/grass0,
/area/hilbertshotel)
"GQ" = (
/obj/item/candle/infinite,
/turf/open/floor/wood/wood_tiled,
/area/hilbertshotel)
"Hx" = (
/obj/structure/flora/ausbushes/sparsegrass,
/obj/structure/flora/ausbushes/brflowers,
/obj/structure/flora/biolumi,
/turf/open/floor/grass/grass0,
/area/hilbertshotel)
"Kc" = (
/obj/structure/flora/rock,
/obj/machinery/atmospherics/components/unary/vent_pump/on,
/obj/structure/flora/ausbushes/brflowers,
/turf/open/floor/grass/grass0,
/area/hilbertshotel)
"Kj" = (
/turf/open/floor/carpet/royalblue,
/area/hilbertshotel)
"KC" = (
/obj/structure/flora/ausbushes/sparsegrass,
/obj/structure/flora/ausbushes/brflowers,
/obj/structure/flora/biolumi/mine,
/turf/open/floor/grass/grass0,
/area/hilbertshotel)
"Ll" = (
/obj/machinery/atmospherics/pipe/simple/supply/hidden{
	dir = 4
	},
/obj/machinery/atmospherics/pipe/simple/scrubbers/hidden/layer3{
	dir = 10
	},
/turf/closed/indestructible/wood,
/area/hilbertshotel)
"Lm" = (
/obj/structure/flora/ausbushes/sparsegrass,
/obj/structure/flora/ausbushes/ywflowers,
/obj/structure/flora/ausbushes/brflowers,
/obj/structure/flora/ausbushes/brflowers,
/obj/structure/flora/biolumi/flower,
/turf/open/floor/grass/grass0,
/area/hilbertshotel)
"LD" = (
/obj/structure/lattice,
/obj/machinery/atmospherics/pipe/simple/supply/hidden{
	dir = 4
	},
/turf/open/space/bluespace,
/area/hilbertshotel)
"Mv" = (
/obj/structure/flora/ausbushes/ywflowers,
/obj/structure/flora/ausbushes/ywflowers,
/obj/structure/flora/ausbushes/brflowers,
/turf/open/floor/grass/grass0,
/area/hilbertshotel)
"MX" = (
/obj/structure/flora/ausbushes/sparsegrass,
/obj/structure/flora/ausbushes/ppflowers,
/obj/structure/flora/ausbushes/ppflowers,
/obj/structure/flora/ausbushes/brflowers,
/turf/open/floor/grass/grass0,
/area/hilbertshotel)
"Ox" = (
/obj/structure/flora/ausbushes/lavendergrass,
/obj/machinery/atmospherics/pipe/simple/supply/hidden,
/obj/structure/flora/ausbushes/ppflowers,
/obj/structure/flora/ausbushes/ywflowers,
/obj/structure/flora/ausbushes/brflowers,
/turf/open/floor/grass/grass0,
/area/hilbertshotel)
"OU" = (
/obj/structure/flora/tree/spookylog,
/obj/structure/flora/ausbushes/sparsegrass,
/obj/structure/flora/ausbushes/brflowers,
/turf/open/floor/grass/grass0,
/area/hilbertshotel)
"Qc" = (
/obj/structure/flora/ausbushes/sparsegrass,
/obj/structure/flora/ausbushes/brflowers,
/turf/open/floor/grass/grass0,
/area/hilbertshotel)
"Ri" = (
/obj/structure/flora/ausbushes/sparsegrass,
/turf/open/floor/grass/grass0,
/area/hilbertshotel)
"RE" = (
/obj/structure/flora/ausbushes/sparsegrass,
/obj/structure/flora/ausbushes/ppflowers,
/obj/structure/flora/ausbushes/ywflowers,
/turf/open/floor/grass/grass0,
/area/hilbertshotel)
"RT" = (
/obj/structure/flora/ausbushes/sparsegrass,
/obj/item/lighter/gold,
/obj/structure/flora/ausbushes/brflowers,
/turf/open/floor/grass/grass0,
/area/hilbertshotel)
"TH" = (
/obj/structure/flora/ausbushes/sparsegrass,
/obj/structure/flora/ausbushes/ywflowers,
/obj/structure/flora/ausbushes/brflowers,
/turf/open/floor/grass/grass0,
/area/hilbertshotel)
"Ve" = (
/obj/structure/flora/ausbushes/sparsegrass,
/obj/structure/flora/ausbushes/ppflowers,
/obj/structure/flora/ausbushes/brflowers,
/turf/open/floor/grass/grass0,
/area/hilbertshotel)
"Vh" = (
/obj/structure/flora/ausbushes/lavendergrass,
/obj/structure/flora/ausbushes/brflowers,
/obj/structure/flora/ausbushes/brflowers,
/turf/open/floor/grass/grass0,
/area/hilbertshotel)
"Vy" = (
/obj/structure/flora/rock,
/obj/machinery/light/floor,
/obj/structure/flora/ausbushes/brflowers,
/turf/open/floor/grass/grass0,
/area/hilbertshotel)
"Wh" = (
/obj/structure/flora/ausbushes/sparsegrass,
/obj/structure/flora/ausbushes/ywflowers,
/turf/open/floor/grass/grass0,
/area/hilbertshotel)
"WY" = (
/obj/structure/flora/ausbushes/ppflowers,
/obj/machinery/atmospherics/pipe/simple/supply/hidden{
	dir = 4
	},
/obj/structure/flora/ausbushes/brflowers,
/obj/structure/flora/ausbushes/brflowers,
/obj/structure/flora/biolumi,
/obj/structure/flora/biolumi/mine,
/turf/open/floor/grass/grass0,
/area/hilbertshotel)
"Xj" = (
/obj/structure/flora/ausbushes/lavendergrass,
/turf/open/floor/grass/grass0,
/area/hilbertshotel)
"XX" = (
/turf/closed/indestructible/hoteldoor{
	icon_state = "door_closed";
	icon = 'icons/obj/doors/puzzledoor/default.dmi'
	},
/area/hilbertshotel)
"Zn" = (
/obj/structure/flora/ausbushes/sparsegrass,
/obj/machinery/light/floor,
/turf/open/floor/grass/grass0,
/area/hilbertshotel)
"Zr" = (
/obj/structure/flora/ausbushes/ppflowers,
/obj/structure/flora/ausbushes/brflowers,
/obj/structure/flora/ausbushes/brflowers,
/turf/open/floor/grass/grass0,
/area/hilbertshotel)

(1,1,1) = {"
gm
gm
gm
zn
zn
XX
zn
zn
zn
zn
zn
zn
zn
gm
gm
gm
"}
(2,1,1) = {"
gm
gm
zn
Qc
TH
rX
RT
iy
tu
vA
Vh
tu
Hx
zn
gm
gm
"}
(3,1,1) = {"
gm
zn
qX
Wh
hd
Wh
Wh
RE
Ri
up
lS
tu
CE
Qc
zn
gm
"}
(4,1,1) = {"
zn
Zr
ko
Wh
sg
tY
tY
tY
tY
tY
tY
aA
Wh
Mv
FZ
zn
"}
(5,1,1) = {"
zn
KC
RE
Zn
tY
tY
GQ
Kj
Kj
GQ
tY
tY
Zn
Wh
Qc
zn
"}
(6,1,1) = {"
zn
Ve
Cd
tY
tY
tY
tY
tY
tY
tY
tY
tY
tY
hd
Qc
zn
"}
(7,1,1) = {"
zn
ph
oy
tY
GQ
tY
Qc
Cm
Qc
Kc
zi
om
zi
Ox
CI
zn
"}
(8,1,1) = {"
zn
MX
vT
tY
Kj
tY
Qc
Ri
th
vA
tY
Kj
tY
RE
uD
zn
"}
(9,1,1) = {"
zn
qq
Qc
tY
Kj
tY
Qc
Ri
Ve
Xj
tY
Kj
tY
qq
WY
zn
"}
(10,1,1) = {"
zn
ji
DQ
tY
GQ
tY
Aq
Qc
wK
Qc
tY
GQ
tY
qq
mO
zn
"}
(11,1,1) = {"
zn
up
Qc
tY
tY
tY
tY
tY
tY
tY
tY
tY
tY
qq
wF
zn
"}
(12,1,1) = {"
zn
Ve
AB
sg
tY
tY
GQ
Kj
Kj
GQ
tY
tY
aA
kq
uD
zn
"}
(13,1,1) = {"
zn
Qc
ka
gK
Vy
tY
tY
tY
tY
tY
tY
mR
kq
wc
eg
zn
"}
(14,1,1) = {"
gm
zn
KC
Qc
vA
vA
rX
Wh
kP
TH
Qc
Ve
up
vA
Ll
FO
"}
(15,1,1) = {"
gm
gm
zn
Hx
CE
Wh
Lm
Qc
wK
vA
OU
DH
vA
zn
LD
fz
"}
(16,1,1) = {"
gm
gm
gm
zn
zn
zn
zn
zn
zn
zn
zn
zn
zn
gj
uP
gj
"}
