//MAP CONVERTED BY dmm2tgm.py THIS HEADER COMMENT PREVENTS RECONVERSION, DO NOT REMOVE
"af" = (
/obj/structure/spacevine,
/obj/structure/flora/ausbushes/brflowers,
/turf/closed/indestructible/wood,
/area/hilbertshotel)
"aA" = (
/obj/structure/flora/ausbushes/sparsegrass,
/obj/machinery/light/floor,
/obj/structure/flora/biolumi/flower,
/turf/open/floor/grass/grass0,
/area/hilbertshotel)
"bg" = (
/obj/structure/spacevine,
/obj/structure/flora/ausbushes/ppflowers,
/turf/closed/indestructible/wood,
/area/hilbertshotel)
"dn" = (
/obj/structure/chair/pew{
	dir = 1
	},
/turf/open/floor/wood/wood_tiled,
/area/hilbertshotel)
"fz" = (
/obj/machinery/telecomms/relay/preset/auto,
/turf/open/floor/catwalk_floor,
/area/hilbertshotel)
"gj" = (
/obj/structure/flora/ausbushes/sparsegrass,
/obj/structure/flora/ausbushes/ppflowers,
/obj/structure/flora/biolumi/flower,
/turf/open/floor/grass/grass0,
/area/hilbertshotel)
"gm" = (
/obj/structure/lattice,
/turf/open/space/bluespace,
/area/hilbertshotel)
"gK" = (
/obj/structure/flora/ausbushes/sparsegrass,
/obj/structure/flora/ausbushes/brflowers,
/obj/structure/flora/ausbushes/brflowers,
/obj/structure/flora/ausbushes/brflowers,
/turf/open/floor/grass/grass0,
/area/hilbertshotel)
"hd" = (
/obj/structure/flora/ausbushes/ppflowers,
/obj/structure/flora/ausbushes/ywflowers,
/turf/open/floor/grass/grass0,
/area/hilbertshotel)
"hY" = (
/obj/structure/chair/pew/left{
	dir = 1
	},
/turf/open/floor/wood/wood_tiled,
/area/hilbertshotel)
"iy" = (
/obj/structure/flora/ausbushes/ywflowers,
/obj/structure/flora/ausbushes/ywflowers,
/obj/structure/flora/ausbushes/brflowers,
/obj/structure/flora/biolumi/lamp,
/turf/open/floor/grass/grass0,
/area/hilbertshotel)
"ji" = (
/obj/structure/flora/tree/spookylog,
/obj/structure/flora/ausbushes/sparsegrass,
/obj/structure/flora/ausbushes/ppflowers,
/obj/structure/flora/ausbushes/brflowers,
/turf/open/floor/grass/grass0,
/area/hilbertshotel)
"ka" = (
/obj/structure/flora/ausbushes/ywflowers,
/obj/structure/flora/ausbushes/ppflowers,
/obj/structure/flora/ausbushes/brflowers,
/turf/open/floor/grass/grass0,
/area/hilbertshotel)
"ko" = (
/obj/structure/flora/rock,
/obj/structure/flora/ausbushes/ywflowers,
/obj/structure/flora/ausbushes/brflowers,
/turf/open/floor/grass/grass0,
/area/hilbertshotel)
"kq" = (
/obj/structure/flora/ausbushes/sparsegrass,
/obj/structure/flora/ausbushes/ppflowers,
/obj/structure/flora/ausbushes/brflowers,
/obj/structure/flora/ausbushes/brflowers,
/turf/open/floor/grass/grass0,
/area/hilbertshotel)
"kP" = (
/obj/structure/flora/ausbushes/sparsegrass,
/obj/structure/flora/ausbushes/ywflowers,
/obj/structure/flora/biolumi/lamp,
/turf/open/floor/grass/grass0,
/area/hilbertshotel)
"lH" = (
/obj/structure/chair/pew{
	dir = 4
	},
/turf/open/floor/wood/wood_tiled,
/area/hilbertshotel)
"lS" = (
/obj/structure/flora/tree/spookylog,
/obj/structure/flora/ausbushes/sparsegrass,
/obj/structure/flora/ausbushes/brflowers,
/obj/structure/flora/ausbushes/brflowers,
/turf/open/floor/grass/grass0,
/area/hilbertshotel)
"mQ" = (
/obj/structure/chair/pew/left,
/turf/open/floor/wood/wood_tiled,
/area/hilbertshotel)
"mR" = (
/obj/structure/flora/ausbushes/sparsegrass,
/obj/machinery/light/floor,
/obj/structure/flora/ausbushes/brflowers,
/obj/structure/flora/ausbushes/brflowers,
/turf/open/floor/grass/grass0,
/area/hilbertshotel)
"oy" = (
/obj/structure/flora/ausbushes/sparsegrass,
/obj/structure/flora/ausbushes/ppflowers,
/obj/structure/flora/ausbushes/ppflowers,
/turf/open/floor/grass/grass0,
/area/hilbertshotel)
"ph" = (
/obj/structure/flora/ausbushes/sparsegrass,
/obj/structure/flora/ausbushes/ppflowers,
/obj/structure/flora/ausbushes/brflowers,
/obj/structure/flora/biolumi/lamp,
/turf/open/floor/grass/grass0,
/area/hilbertshotel)
"qq" = (
/obj/structure/flora/ausbushes/sparsegrass,
/obj/structure/flora/ausbushes/ppflowers,
/turf/open/floor/grass/grass0,
/area/hilbertshotel)
"qX" = (
/obj/structure/flora/ausbushes/sparsegrass,
/obj/structure/flora/ausbushes/brflowers,
/obj/structure/flora/biolumi/flower,
/turf/open/floor/grass/grass0,
/area/hilbertshotel)
"rX" = (
/obj/structure/flora/ausbushes/lavendergrass,
/obj/structure/flora/ausbushes/ywflowers,
/obj/structure/flora/ausbushes/brflowers,
/turf/open/floor/grass/grass0,
/area/hilbertshotel)
"sg" = (
/obj/structure/flora/ausbushes/sparsegrass,
/obj/machinery/light/floor,
/obj/structure/flora/ausbushes/brflowers,
/turf/open/floor/grass/grass0,
/area/hilbertshotel)
"th" = (
/obj/structure/flora/tree/jungle{
	pixel_x = -31;
	pixel_y = 0
	},
/obj/structure/flora/ausbushes/sparsegrass,
/obj/structure/flora/ausbushes/ppflowers,
/turf/open/floor/grass/grass0,
/area/hilbertshotel)
"tu" = (
/obj/structure/flora/ausbushes/sparsegrass,
/obj/structure/flora/ausbushes/ywflowers,
/obj/structure/flora/ausbushes/brflowers,
/obj/structure/flora/ausbushes/brflowers,
/turf/open/floor/grass/grass0,
/area/hilbertshotel)
"tY" = (
/turf/open/floor/wood/wood_tiled,
/area/hilbertshotel)
"up" = (
/obj/structure/flora/ausbushes/ppflowers,
/obj/structure/flora/ausbushes/ppflowers,
/obj/structure/flora/ausbushes/brflowers,
/obj/structure/flora/ausbushes/brflowers,
/turf/open/floor/grass/grass0,
/area/hilbertshotel)
"uD" = (
/obj/structure/flora/ausbushes/ywflowers,
/obj/structure/flora/ausbushes/brflowers,
/obj/structure/flora/biolumi/mine,
/turf/open/floor/grass/grass0,
/area/hilbertshotel)
"uV" = (
/obj/structure/spacevine,
/obj/structure/flora/ausbushes/brflowers,
/obj/structure/flora/ausbushes/ywflowers,
/turf/closed/indestructible/wood,
/area/hilbertshotel)
"vd" = (
/obj/structure/chair/pew{
	dir = 8
	},
/turf/open/floor/wood/wood_tiled,
/area/hilbertshotel)
"vA" = (
/obj/structure/flora/ausbushes/sparsegrass,
/obj/structure/flora/ausbushes/brflowers,
/obj/structure/flora/ausbushes/brflowers,
/turf/open/floor/grass/grass0,
/area/hilbertshotel)
"vT" = (
/obj/structure/flora/ausbushes/ywflowers,
/obj/structure/flora/ausbushes/ppflowers,
/obj/structure/flora/ausbushes/brflowers,
/obj/structure/flora/ausbushes/brflowers,
/turf/open/floor/grass/grass0,
/area/hilbertshotel)
"wc" = (
/obj/structure/flora/rock,
/obj/structure/flora/ausbushes/brflowers,
/turf/open/floor/grass/grass0,
/area/hilbertshotel)
"wF" = (
/obj/structure/flora/ausbushes/ywflowers,
/turf/open/floor/grass/grass0,
/area/hilbertshotel)
"wK" = (
/obj/structure/flora/ausbushes/ywflowers,
/obj/structure/flora/ausbushes/brflowers,
/turf/open/floor/grass/grass0,
/area/hilbertshotel)
"zi" = (
/obj/structure/flora/ausbushes/sparsegrass,
/obj/structure/flora/ausbushes/brflowers,
/obj/structure/flora/ausbushes/brflowers,
/obj/structure/flora/biolumi/flower,
/turf/open/floor/grass/grass0,
/area/hilbertshotel)
"zn" = (
/obj/structure/spacevine,
/obj/structure/flora/ausbushes/ywflowers,
/turf/closed/indestructible/wood,
/area/hilbertshotel)
"zX" = (
/obj/structure/chair/pew/right{
	dir = 1
	},
/turf/open/floor/wood/wood_tiled,
/area/hilbertshotel)
"Aq" = (
/obj/structure/flora/ausbushes/lavendergrass,
/obj/structure/flora/ausbushes/brflowers,
/obj/structure/flora/biolumi/flower,
/turf/open/floor/grass/grass0,
/area/hilbertshotel)
"AB" = (
/obj/structure/flora/ausbushes/sparsegrass,
/obj/structure/flora/ausbushes/ppflowers,
/obj/structure/flora/ausbushes/brflowers,
/obj/structure/flora/ausbushes/brflowers,
/obj/structure/flora/biolumi/flower,
/turf/open/floor/grass/grass0,
/area/hilbertshotel)
"Cd" = (
/obj/structure/flora/ausbushes/sparsegrass,
/obj/structure/flora/ausbushes/ppflowers,
/obj/structure/flora/ausbushes/ppflowers,
/obj/structure/flora/ausbushes/ywflowers,
/turf/open/floor/grass/grass0,
/area/hilbertshotel)
"Cl" = (
/obj/structure/spacevine,
/obj/structure/flora/ausbushes/brflowers,
/obj/structure/flora/ausbushes/ppflowers,
/turf/closed/indestructible/wood,
/area/hilbertshotel)
"Cm" = (
/obj/structure/flora/ausbushes/ppflowers,
/obj/structure/flora/ausbushes/brflowers,
/turf/open/floor/grass/grass0,
/area/hilbertshotel)
"CE" = (
/obj/structure/flora/ausbushes/lavendergrass,
/obj/structure/flora/ausbushes/ywflowers,
/turf/open/floor/grass/grass0,
/area/hilbertshotel)
"Dd" = (
/obj/structure/spacevine,
/obj/structure/flora/ausbushes/ywflowers,
/obj/structure/flora/ausbushes/ppflowers,
/turf/closed/indestructible/wood,
/area/hilbertshotel)
"DH" = (
/obj/structure/flora/ausbushes/sparsegrass,
/obj/structure/flora/ausbushes/brflowers,
/obj/structure/flora/ausbushes/brflowers,
/obj/structure/flora/biolumi,
/turf/open/floor/grass/grass0,
/area/hilbertshotel)
"DQ" = (
/obj/structure/flora/ausbushes/sparsegrass,
/obj/structure/flora/ausbushes/brflowers,
/obj/structure/flora/biolumi/lamp,
/turf/open/floor/grass/grass0,
/area/hilbertshotel)
"Ep" = (
/obj/structure/spacevine,
/obj/structure/flora/ausbushes/brflowers,
/obj/structure/flora/ausbushes/ywflowers,
/obj/structure/flora/ausbushes/ppflowers,
/turf/closed/indestructible/wood,
/area/hilbertshotel)
"FZ" = (
/obj/structure/flora/ausbushes/sparsegrass,
/obj/structure/flora/biolumi/flower,
/turf/open/floor/grass/grass0,
/area/hilbertshotel)
"Gj" = (
/obj/structure/chair/pew,
/turf/open/floor/wood/wood_tiled,
/area/hilbertshotel)
"GQ" = (
/obj/item/candle/infinite,
/turf/open/floor/wood/wood_tiled,
/area/hilbertshotel)
"Hx" = (
/obj/structure/flora/ausbushes/sparsegrass,
/obj/structure/flora/ausbushes/brflowers,
/obj/structure/flora/biolumi,
/turf/open/floor/grass/grass0,
/area/hilbertshotel)
"Kc" = (
/obj/structure/flora/rock,
/obj/structure/flora/ausbushes/brflowers,
/obj/structure/flora/ausbushes/ppflowers,
/turf/open/floor/grass/grass0,
/area/hilbertshotel)
"Kj" = (
/turf/open/floor/carpet/royalblue,
/area/hilbertshotel)
"KC" = (
/obj/structure/flora/ausbushes/sparsegrass,
/obj/structure/flora/ausbushes/brflowers,
/obj/structure/flora/biolumi/mine,
/turf/open/floor/grass/grass0,
/area/hilbertshotel)
"Lm" = (
/obj/structure/flora/ausbushes/sparsegrass,
/obj/structure/flora/ausbushes/ywflowers,
/obj/structure/flora/ausbushes/brflowers,
/obj/structure/flora/ausbushes/brflowers,
/obj/structure/flora/biolumi/flower,
/turf/open/floor/grass/grass0,
/area/hilbertshotel)
"Mo" = (
/obj/structure/spacevine,
/turf/closed/indestructible/wood,
/area/hilbertshotel)
"Mv" = (
/obj/structure/flora/ausbushes/ywflowers,
/obj/structure/flora/ausbushes/ywflowers,
/obj/structure/flora/ausbushes/brflowers,
/turf/open/floor/grass/grass0,
/area/hilbertshotel)
"MX" = (
/obj/structure/flora/ausbushes/sparsegrass,
/obj/structure/flora/ausbushes/ppflowers,
/obj/structure/flora/ausbushes/ppflowers,
/obj/structure/flora/ausbushes/brflowers,
/turf/open/floor/grass/grass0,
/area/hilbertshotel)
"Ox" = (
/obj/structure/flora/ausbushes/lavendergrass,
/obj/structure/flora/ausbushes/ppflowers,
/obj/structure/flora/ausbushes/ywflowers,
/obj/structure/flora/ausbushes/brflowers,
/turf/open/floor/grass/grass0,
/area/hilbertshotel)
"OU" = (
/obj/structure/flora/tree/spookylog,
/obj/structure/flora/ausbushes/sparsegrass,
/obj/structure/flora/ausbushes/brflowers,
/turf/open/floor/grass/grass0,
/area/hilbertshotel)
"OY" = (
/obj/structure/chair/pew/left{
	dir = 4
	},
/turf/open/floor/wood/wood_tiled,
/area/hilbertshotel)
"Qc" = (
/obj/structure/flora/ausbushes/sparsegrass,
/obj/structure/flora/ausbushes/brflowers,
/turf/open/floor/grass/grass0,
/area/hilbertshotel)
"Qf" = (
/obj/structure/chair/pew/right,
/turf/open/floor/wood/wood_tiled,
/area/hilbertshotel)
"QL" = (
/obj/structure/chair/pew/right{
	dir = 4
	},
/turf/open/floor/wood/wood_tiled,
/area/hilbertshotel)
"Ri" = (
/obj/structure/flora/ausbushes/sparsegrass,
/turf/open/floor/grass/grass0,
/area/hilbertshotel)
"RE" = (
/obj/structure/flora/ausbushes/sparsegrass,
/obj/structure/flora/ausbushes/ppflowers,
/obj/structure/flora/ausbushes/ywflowers,
/turf/open/floor/grass/grass0,
/area/hilbertshotel)
"RT" = (
/obj/structure/flora/ausbushes/sparsegrass,
/obj/item/lighter/gold,
/obj/structure/flora/ausbushes/brflowers,
/turf/open/floor/grass/grass0,
/area/hilbertshotel)
"TH" = (
/obj/structure/flora/ausbushes/sparsegrass,
/obj/structure/flora/ausbushes/ywflowers,
/obj/structure/flora/ausbushes/brflowers,
/turf/open/floor/grass/grass0,
/area/hilbertshotel)
"Ve" = (
/obj/structure/flora/ausbushes/sparsegrass,
/obj/structure/flora/ausbushes/ppflowers,
/obj/structure/flora/ausbushes/brflowers,
/turf/open/floor/grass/grass0,
/area/hilbertshotel)
"Vh" = (
/obj/structure/flora/ausbushes/lavendergrass,
/obj/structure/flora/ausbushes/brflowers,
/obj/structure/flora/ausbushes/brflowers,
/turf/open/floor/grass/grass0,
/area/hilbertshotel)
"Vy" = (
/obj/structure/flora/rock,
/obj/machinery/light/floor,
/obj/structure/flora/ausbushes/brflowers,
/turf/open/floor/grass/grass0,
/area/hilbertshotel)
"We" = (
/obj/structure/chair/pew/left{
	dir = 8
	},
/turf/open/floor/wood/wood_tiled,
/area/hilbertshotel)
"Wh" = (
/obj/structure/flora/ausbushes/sparsegrass,
/obj/structure/flora/ausbushes/ywflowers,
/turf/open/floor/grass/grass0,
/area/hilbertshotel)
"WO" = (
/obj/structure/chair/pew/right{
	dir = 8
	},
/turf/open/floor/wood/wood_tiled,
/area/hilbertshotel)
"WY" = (
/obj/structure/flora/ausbushes/ppflowers,
/obj/structure/flora/ausbushes/brflowers,
/obj/structure/flora/ausbushes/brflowers,
/obj/structure/flora/biolumi,
/obj/structure/flora/biolumi/mine,
/turf/open/floor/grass/grass0,
/area/hilbertshotel)
"Xj" = (
/obj/structure/flora/ausbushes/lavendergrass,
/obj/structure/flora/ausbushes/ppflowers,
/turf/open/floor/grass/grass0,
/area/hilbertshotel)
"XX" = (
/turf/closed/indestructible/hoteldoor{
	icon_state = "door_closed";
	icon = 'icons/obj/doors/puzzledoor/default.dmi'
	},
/area/hilbertshotel)
"Zn" = (
/obj/structure/flora/ausbushes/sparsegrass,
/obj/machinery/light/floor,
/turf/open/floor/grass/grass0,
/area/hilbertshotel)
"Zr" = (
/obj/structure/flora/ausbushes/ppflowers,
/obj/structure/flora/ausbushes/brflowers,
/obj/structure/flora/ausbushes/brflowers,
/turf/open/floor/grass/grass0,
/area/hilbertshotel)

(1,1,1) = {"
gm
gm
gm
bg
Ep
XX
Mo
Dd
af
zn
Dd
zn
af
gm
gm
gm
"}
(2,1,1) = {"
gm
gm
Cl
Qc
TH
rX
RT
iy
tu
vA
Vh
tu
Hx
zn
gm
gm
"}
(3,1,1) = {"
gm
zn
qX
Wh
hd
Wh
Wh
RE
Ri
up
lS
tu
CE
Qc
Dd
gm
"}
(4,1,1) = {"
Dd
Zr
ko
Wh
sg
tY
QL
lH
lH
OY
tY
aA
Wh
Mv
FZ
zn
"}
(5,1,1) = {"
zn
KC
RE
Zn
tY
tY
GQ
Kj
Kj
GQ
tY
tY
Zn
Wh
Qc
zn
"}
(6,1,1) = {"
bg
Ve
Cd
tY
tY
tY
tY
tY
tY
tY
tY
tY
tY
hd
Qc
Ep
"}
(7,1,1) = {"
Cl
ph
oy
mQ
GQ
tY
qX
Cm
Qc
Kc
tY
GQ
hY
Ox
Ve
uV
"}
(8,1,1) = {"
zn
MX
vT
Gj
Kj
tY
Qc
gj
th
zi
tY
Kj
dn
RE
Qc
Dd
"}
(9,1,1) = {"
uV
qq
Qc
Gj
Kj
tY
DQ
qq
Ve
Xj
tY
Kj
dn
qq
WY
af
"}
(10,1,1) = {"
zn
ji
DQ
Qf
GQ
tY
Aq
Qc
uD
Qc
tY
GQ
zX
qq
Hx
bg
"}
(11,1,1) = {"
zn
up
Qc
tY
tY
tY
tY
tY
tY
tY
tY
tY
tY
qq
wF
uV
"}
(12,1,1) = {"
Ep
Ve
AB
sg
tY
tY
GQ
Kj
Kj
GQ
tY
tY
aA
kq
Qc
bg
"}
(13,1,1) = {"
Dd
Qc
ka
gK
Vy
tY
We
vd
vd
WO
tY
mR
kq
wc
qX
zn
"}
(14,1,1) = {"
gm
bg
KC
Qc
vA
vA
rX
Wh
kP
TH
Qc
Ve
up
vA
bg
gm
"}
(15,1,1) = {"
gm
gm
zn
Hx
CE
Wh
Lm
Qc
wK
vA
OU
DH
vA
bg
gm
fz
"}
(16,1,1) = {"
gm
gm
gm
bg
Cl
Dd
Cl
Dd
zn
Ep
zn
Dd
Ep
gm
gm
gm
"}
