//MAP CONVERTED BY dmm2tgm.py THIS HEADER COMMENT PREVENTS RECONVERSION, DO NOT REMOVE
"ar" = (
/obj/structure/table/wood/poker,
/obj/item/storage/fancy/donut_box{
	pixel_y = 5
	},
/turf/open/floor/carpet,
/area/hilbertshotel)
"aC" = (
/obj/effect/turf_decal/siding/wood{
	dir = 8
	},
/obj/machinery/vending/games{
	shut_up = 1
	},
/turf/open/floor/wood/wood_tiled,
/area/hilbertshotel)
"aS" = (
/obj/effect/turf_decal/siding/wood{
	dir = 1
	},
/turf/open/floor/carpet,
/area/hilbertshotel)
"bw" = (
/obj/structure/table/reinforced,
/obj/machinery/microwave{
	pixel_x = -2;
	pixel_y = 6
	},
/turf/open/floor/mineral/titanium/tiled/white,
/area/hilbertshotel)
"bz" = (
/obj/effect/turf_decal/siding/wood/corner,
/obj/structure/table/wood,
/obj/item/pizzabox/margherita{
	pixel_y = 11
	},
/obj/effect/turf_decal/siding/wood{
	dir = 1
	},
/obj/effect/turf_decal/siding/wood,
/turf/open/floor/wood/wood_tiled,
/area/hilbertshotel)
"bR" = (
/obj/effect/turf_decal/siding/wood{
	dir = 1
	},
/turf/open/floor/wood/wood_large,
/area/hilbertshotel)
"cy" = (
/obj/machinery/light_switch/directional/north{
	pixel_x = 18
	},
/turf/open/floor/carpet{
	icon_state = "carpetsymbol"
	},
/area/hilbertshotel)
"cz" = (
/obj/effect/turf_decal/siding/wood{
	dir = 4
	},
/turf/open/floor/wood/wood_tiled,
/area/hilbertshotel)
"dw" = (
/obj/item/kitchen/fork,
/obj/item/kitchen/fork,
/obj/item/kitchen/fork,
/obj/item/kitchen/fork,
/obj/structure/closet/secure_closet/freezer/fridge,
/obj/item/reagent_containers/food/drinks/beer,
/obj/item/reagent_containers/food/drinks/beer,
/obj/item/reagent_containers/food/drinks/beer,
/obj/item/reagent_containers/food/drinks/beer,
/obj/item/reagent_containers/food/drinks/beer,
/obj/item/reagent_containers/food/drinks/beer,
/obj/item/reagent_containers/food/drinks/beer,
/obj/item/reagent_containers/food/drinks/beer,
/obj/item/kitchen/knife,
/turf/open/floor/plasteel/kitchen_coldroom,
/area/hilbertshotel)
"dT" = (
/turf/open/floor/wood/wood_tiled,
/area/hilbertshotel)
"eO" = (
/obj/structure/bookcase/random,
/obj/effect/turf_decal/siding/wood{
	dir = 1
	},
/turf/open/floor/wood/wood_tiled,
/area/hilbertshotel)
"fa" = (
/obj/structure/railing{
	dir = 8
	},
/turf/open/pool,
/area/hilbertshotel)
"fi" = (
/obj/structure/chair,
/turf/open/floor/plasteel/kitchen_coldroom,
/area/hilbertshotel)
"gQ" = (
/obj/structure/chair/sofa/corp/corner,
/obj/machinery/light{
	dir = 4
	},
/turf/open/floor/carpet,
/area/hilbertshotel)
"ho" = (
/turf/open/indestructible/hoteltile,
/area/hilbertshotel)
"ik" = (
/obj/effect/turf_decal/siding/white{
	dir = 4
	},
/turf/open/indestructible/hoteltile,
/area/hilbertshotel)
"iL" = (
/obj/effect/turf_decal/siding/wood,
/turf/open/floor/wood/wood_tiled,
/area/hilbertshotel)
"jr" = (
/obj/machinery/light_switch/directional/south,
/turf/open/floor/carpet/purple,
/area/hilbertshotel)
"jx" = (
/obj/structure/chair/office{
	dir = 4
	},
/obj/effect/turf_decal/siding/wood{
	dir = 10
	},
/turf/open/floor/wood/wood_tiled,
/area/hilbertshotel)
"jT" = (
/obj/item/kirbyplants/random,
/obj/machinery/light_switch/directional/north,
/turf/open/floor/plasteel/kitchen_coldroom,
/area/hilbertshotel)
"kh" = (
/obj/effect/turf_decal/siding/wood,
/turf/open/floor/carpet,
/area/hilbertshotel)
"kq" = (
/obj/structure/table,
/obj/effect/spawner/lootdrop/three_course_meal,
/obj/machinery/atmospherics/components/unary/vent_pump/hilbertshotel{
	dir = 4
	},
/turf/open/floor/plasteel/kitchen_coldroom,
/area/hilbertshotel)
"kD" = (
/obj/effect/turf_decal/siding/wood/corner,
/turf/open/floor/wood/wood_tiled,
/area/hilbertshotel)
"kS" = (
/obj/structure/table/wood/poker,
/obj/item/toy/cards/deck,
/turf/open/floor/carpet,
/area/hilbertshotel)
"kW" = (
/obj/structure/window{
	dir = 8
	},
/mob/living/simple_animal/pet/gondola,
/obj/structure/flora/junglebush,
/turf/open/floor/grass/grass0,
/area/hilbertshotel)
"lO" = (
/obj/item/choice_beacon/box/plushie,
/turf/open/floor/carpet,
/area/hilbertshotel)
"lU" = (
/obj/effect/turf_decal/siding/wood{
	dir = 6
	},
/obj/machinery/light{
	dir = 4
	},
/turf/open/floor/carpet/royalblue,
/area/hilbertshotel)
"md" = (
/obj/structure/table/wood,
/obj/item/flashlight/lamp/green{
	pixel_x = 5;
	pixel_y = 14
	},
/obj/effect/turf_decal/siding/wood{
	dir = 5
	},
/turf/open/floor/wood/wood_tiled,
/area/hilbertshotel)
"oZ" = (
/obj/machinery/telecomms/relay/preset/auto,
/turf/open/floor/catwalk_floor,
/area/hilbertshotel)
"pm" = (
/obj/structure/table/wood,
/obj/effect/turf_decal/siding/wood{
	dir = 9
	},
/obj/item/reagent_containers/rag/towel/syndicate,
/obj/item/reagent_containers/rag/towel/syndicate{
	pixel_x = -5;
	pixel_y = 5
	},
/obj/item/reagent_containers/rag/towel/syndicate{
	pixel_x = 5;
	pixel_y = 5
	},
/turf/open/floor/wood/wood_tiled,
/area/hilbertshotel)
"pD" = (
/obj/effect/turf_decal/siding/wood,
/obj/effect/turf_decal/siding/wood{
	dir = 4
	},
/obj/structure/table/wood,
/obj/machinery/light{
	dir = 4
	},
/turf/open/floor/carpet,
/area/hilbertshotel)
"pX" = (
/obj/machinery/jukebox{
	icon_state = "telescreen";
	name = "modern jukebox";
	desc = "A modern music player.";
	area_limited = 1
	},
/turf/closed/indestructible/wall,
/area/hilbertshotel)
"st" = (
/obj/machinery/door/morgue,
/turf/open/floor/plasteel/kitchen_coldroom,
/area/hilbertshotel)
"tZ" = (
/obj/machinery/vending/dinnerware{
	contraband = list(/obj/item/reagent_containers/food/condiment/flour=4);
	desc = "This vendor is full of condiments to put on food.";
	name = "\improper Condiments Vendor";
	products = list(/obj/item/storage/bag/tray=8,/obj/item/reagent_containers/food/drinks/drinkingglass=10,/obj/item/storage/box/cups=5,/obj/item/reagent_containers/food/condiment/pack/ketchup=20,/obj/item/reagent_containers/food/condiment/pack/mustard=20,/obj/item/reagent_containers/food/condiment/pack/hotsauce=20,/obj/item/reagent_containers/food/condiment/pack/astrotame=20,/obj/item/reagent_containers/food/condiment/saltshaker=20,/obj/item/reagent_containers/food/condiment/peppermill=20);
	shut_up = 1
	},
/turf/open/floor/mineral/titanium/tiled/white,
/area/hilbertshotel)
"uX" = (
/obj/structure/chair/sofa/corp/left{
	dir = 8
	},
/turf/open/floor/carpet,
/area/hilbertshotel)
"wb" = (
/obj/structure/closet/cabinet,
/obj/effect/turf_decal/siding/wood{
	dir = 10
	},
/obj/machinery/light{
	dir = 8
	},
/turf/open/floor/wood/wood_large,
/area/hilbertshotel)
"wl" = (
/turf/open/floor/plasteel/kitchen_coldroom,
/area/hilbertshotel)
"wu" = (
/obj/machinery/door/morgue,
/turf/open/floor/wood/wood_tiled,
/area/hilbertshotel)
"wv" = (
/obj/machinery/vending/boozeomat{
	shut_up = 1
	},
/turf/closed/indestructible/wood,
/area/hilbertshotel)
"wS" = (
/obj/structure/closet/cabinet,
/obj/effect/turf_decal/siding/wood{
	dir = 1
	},
/obj/machinery/light{
	dir = 1
	},
/turf/open/floor/wood/wood_tiled,
/area/hilbertshotel)
"xT" = (
/turf/closed/indestructible/wall,
/area/hilbertshotel)
"yP" = (
/obj/structure/chair{
	dir = 1
	},
/obj/machinery/light{
	dir = 8
	},
/turf/open/floor/plasteel/kitchen_coldroom,
/area/hilbertshotel)
"zA" = (
/obj/effect/turf_decal/siding/wood{
	dir = 6
	},
/obj/structure/table/wood,
/obj/effect/turf_decal/siding/wood{
	dir = 1
	},
/obj/effect/turf_decal/siding/wood,
/turf/open/floor/wood/wood_tiled,
/area/hilbertshotel)
"zY" = (
/obj/item/kirbyplants/random,
/obj/effect/turf_decal/siding/wood,
/turf/open/floor/wood/wood_large,
/area/hilbertshotel)
"Ae" = (
/obj/machinery/door/morgue,
/turf/open/indestructible/hoteltile,
/area/hilbertshotel)
"AE" = (
/obj/effect/turf_decal/siding/wood{
	dir = 9
	},
/obj/structure/musician/piano{
	icon_state = "piano"
	},
/turf/open/floor/wood/wood_tiled,
/area/hilbertshotel)
"AY" = (
/obj/effect/turf_decal/siding/wood{
	dir = 1
	},
/obj/structure/chair/stool/bar,
/turf/open/floor/wood/wood_tiled,
/area/hilbertshotel)
"BR" = (
/obj/structure/chair/comfy/brown{
	dir = 4
	},
/turf/open/floor/carpet,
/area/hilbertshotel)
"DR" = (
/obj/effect/turf_decal/siding/wood/corner{
	dir = 8
	},
/obj/effect/turf_decal/siding/wood/corner{
	dir = 1
	},
/turf/open/floor/wood/wood_tiled,
/area/hilbertshotel)
"DX" = (
/obj/machinery/computer{
	dir = 8
	},
/turf/open/floor/carpet/purple,
/area/hilbertshotel)
"Ea" = (
/obj/machinery/vending/kink{
	shut_up = 1
	},
/obj/effect/turf_decal/siding/wood{
	dir = 1
	},
/obj/effect/turf_decal/siding/wood{
	dir = 4
	},
/turf/open/floor/carpet,
/area/hilbertshotel)
"EX" = (
/obj/structure/table,
/obj/effect/spawner/lootdrop/three_course_meal,
/turf/open/floor/plasteel/kitchen_coldroom,
/area/hilbertshotel)
"FN" = (
/turf/open/space/bluespace,
/area/hilbertshotel)
"Gv" = (
/obj/structure/chair/sofa/corp,
/turf/open/floor/carpet,
/area/hilbertshotel)
"Hw" = (
/obj/structure/chair/stool/bar,
/turf/open/floor/wood/wood_tiled,
/area/hilbertshotel)
"HO" = (
/obj/structure/railing/corner{
	dir = 1
	},
/obj/machinery/light,
/obj/structure/pool/ladder,
/turf/open/pool,
/area/hilbertshotel)
"Ib" = (
/turf/open/floor/carpet,
/area/hilbertshotel)
"Ix" = (
/obj/structure/bed/double,
/obj/item/bedsheet/random/double,
/obj/effect/turf_decal/siding/wood{
	dir = 4
	},
/turf/open/floor/wood/wood_tiled,
/area/hilbertshotel)
"Je" = (
/obj/structure/dresser,
/obj/effect/turf_decal/siding/wood{
	dir = 1
	},
/turf/open/floor/wood/wood_tiled,
/area/hilbertshotel)
"JW" = (
/obj/item/kirbyplants/random,
/obj/effect/turf_decal/siding/wood/corner,
/obj/effect/turf_decal/siding/wood{
	dir = 10
	},
/turf/open/floor/wood/wood_tiled,
/area/hilbertshotel)
"Mj" = (
/turf/open/floor/carpet/purple,
/area/hilbertshotel)
"Mk" = (
/obj/machinery/light_switch/directional/north,
/obj/structure/curtain,
/obj/item/soap/deluxe,
/obj/machinery/shower,
/turf/open/floor/plasteel/showroomfloor/shower,
/area/hilbertshotel)
"Mp" = (
/obj/structure/bed/dogbed,
/obj/effect/turf_decal/siding/wood{
	dir = 6
	},
/turf/open/floor/wood/wood_tiled,
/area/hilbertshotel)
"MO" = (
/obj/structure/chair{
	dir = 8
	},
/turf/open/floor/plasteel/kitchen_coldroom,
/area/hilbertshotel)
"Nb" = (
/obj/structure/sink/kitchen,
/turf/open/indestructible/hoteltile,
/area/hilbertshotel)
"Oh" = (
/obj/machinery/vending/wallmed/directional/west{
	shut_up = 1
	},
/obj/structure/table,
/obj/structure/bedsheetbin,
/turf/open/indestructible/hoteltile,
/area/hilbertshotel)
"Py" = (
/obj/structure/table/reinforced,
/obj/item/kitchen/rollingpin{
	pixel_x = -3
	},
/obj/machinery/light{
	dir = 4
	},
/turf/open/floor/mineral/titanium/tiled/white,
/area/hilbertshotel)
"PK" = (
/obj/structure/table/reinforced,
/obj/effect/spawner/lootdrop/three_course_meal,
/turf/open/floor/plasteel/kitchen_coldroom,
/area/hilbertshotel)
"QJ" = (
/obj/structure/table/wood/poker,
/obj/structure/noticeboard{
	dir = 4;
	pixel_x = -64;
	pixel_y = -32
	},
/turf/open/floor/carpet,
/area/hilbertshotel)
"QN" = (
/obj/structure/sign/poster/contraband/random,
/turf/closed/indestructible/wall,
/area/hilbertshotel)
"RF" = (
/obj/machinery/shower{
	dir = 8
	},
/turf/open/pool,
/area/hilbertshotel)
"RM" = (
/obj/structure/window{
	dir = 8
	},
/obj/structure/window{
	dir = 1
	},
/obj/structure/flora/junglebush,
/obj/structure/flora/junglebush/large,
/turf/open/floor/grass/grass0,
/area/hilbertshotel)
"SS" = (
/turf/closed/indestructible/hoteldoor{
	icon_state = "door_closed";
	icon = 'icons/obj/doors/puzzledoor/default.dmi'
	},
/area/hilbertshotel)
"SV" = (
/obj/structure/chair{
	dir = 1
	},
/turf/open/floor/plasteel/kitchen_coldroom,
/area/hilbertshotel)
"Ta" = (
/turf/open/pool,
/area/hilbertshotel)
"Tj" = (
/obj/effect/turf_decal/siding/wood{
	dir = 8
	},
/obj/machinery/light{
	dir = 8
	},
/turf/open/floor/wood/wood_tiled,
/area/hilbertshotel)
"Tl" = (
/turf/open/floor/carpet/royalblue,
/area/hilbertshotel)
"Tu" = (
/obj/structure/toilet{
	dir = 8
	},
/obj/machinery/light/small{
	dir = 4
	},
/turf/open/indestructible/hoteltile,
/area/hilbertshotel)
"Ul" = (
/obj/structure/curtain,
/turf/open/indestructible/hoteltile,
/area/hilbertshotel)
"UQ" = (
/obj/structure/chair/sofa/corp/right,
/turf/open/floor/carpet,
/area/hilbertshotel)
"UU" = (
/obj/effect/turf_decal/siding/wood{
	dir = 8
	},
/obj/machinery/light_switch/directional/west,
/obj/item/kirbyplants/random,
/turf/open/floor/wood/wood_tiled,
/area/hilbertshotel)
"Vo" = (
/obj/effect/turf_decal/siding/wood{
	dir = 1
	},
/turf/open/floor/wood/wood_tiled,
/area/hilbertshotel)
"WI" = (
/obj/structure/sink/kitchen{
	dir = 1
	},
/obj/structure/table/reinforced,
/turf/open/floor/plasteel/kitchen_coldroom,
/area/hilbertshotel)
"WN" = (
/obj/structure/table/wood,
/obj/effect/turf_decal/siding/wood{
	dir = 1
	},
/obj/effect/turf_decal/siding/wood,
/obj/effect/turf_decal/siding/wood{
	dir = 8
	},
/turf/open/floor/wood/wood_tiled,
/area/hilbertshotel)
"WX" = (
/obj/effect/turf_decal/siding/wood{
	dir = 8
	},
/turf/open/floor/wood/wood_tiled,
/area/hilbertshotel)
"Yc" = (
/obj/structure/closet/crate/bin,
/turf/open/floor/plasteel/kitchen_coldroom,
/area/hilbertshotel)
"YW" = (
/obj/effect/turf_decal/siding/wood/corner{
	dir = 8
	},
/turf/open/floor/wood/wood_tiled,
/area/hilbertshotel)
"Zq" = (
/obj/item/kirbyplants/random,
/turf/open/floor/mineral/titanium/tiled/white,
/area/hilbertshotel)

(1,1,1) = {"
FN
FN
FN
FN
FN
FN
FN
FN
FN
FN
FN
FN
FN
FN
FN
FN
"}
(2,1,1) = {"
FN
FN
xT
xT
xT
xT
xT
SS
xT
xT
xT
QN
xT
xT
xT
FN
"}
(3,1,1) = {"
FN
FN
xT
pm
WX
jx
xT
cy
wb
xT
jT
EX
yP
Yc
xT
FN
"}
(4,1,1) = {"
FN
FN
xT
eO
Mj
DX
xT
bR
zY
wv
fi
kq
SV
PK
xT
FN
"}
(5,1,1) = {"
FN
FN
xT
wS
Mj
Mj
wu
Tl
Tl
st
wl
MO
wl
WI
xT
FN
"}
(6,1,1) = {"
FN
FN
QN
Je
Mj
jr
xT
Tl
Tl
st
wl
wl
wl
dw
xT
FN
"}
(7,1,1) = {"
FN
FN
xT
md
Ix
Mp
xT
Tl
lU
xT
bw
Py
tZ
Zq
xT
FN
"}
(8,1,1) = {"
FN
FN
xT
xT
xT
xT
xT
wu
xT
QN
xT
xT
xT
xT
xT
FN
"}
(9,1,1) = {"
FN
oZ
xT
AE
ar
BR
Tj
DR
UU
aC
JW
xT
Mk
Oh
xT
FN
"}
(10,1,1) = {"
FN
FN
xT
AY
QJ
kS
Hw
kD
cz
dT
YW
Ae
ho
Tu
xT
FN
"}
(11,1,1) = {"
FN
FN
xT
Vo
Hw
Hw
dT
iL
QN
aS
kh
xT
Ul
xT
xT
FN
"}
(12,1,1) = {"
FN
FN
QN
UQ
Ib
WN
Ib
Ib
pX
aS
kh
xT
ik
Nb
xT
FN
"}
(13,1,1) = {"
FN
FN
xT
Gv
Ib
bz
lO
Ib
xT
aS
kh
xT
fa
HO
xT
FN
"}
(14,1,1) = {"
FN
FN
xT
gQ
uX
zA
RM
kW
xT
Ea
pD
xT
RF
Ta
xT
FN
"}
(15,1,1) = {"
FN
FN
xT
xT
xT
xT
xT
xT
xT
xT
xT
xT
xT
xT
xT
FN
"}
(16,1,1) = {"
FN
FN
FN
FN
FN
FN
FN
FN
FN
FN
FN
FN
FN
FN
FN
FN
"}
