//MAP CONVERTED BY dmm2tgm.py THIS HEADER COMMENT PREVENTS RECONVERSION, DO NOT REMOVE
"aN" = (
/obj/machinery/light_switch/directional/east,
/obj/structure/dresser,
/turf/open/floor/carpet/red,
/area/hilbertshotel)
"bd" = (
/obj/effect/turf_decal/siding/wood{
	dir = 8
	},
/obj/structure/sign/painting/library{
	pixel_x = -32
	},
/turf/open/floor/carpet/royalblue,
/area/hilbertshotel)
"dm" = (
/obj/effect/turf_decal/trimline/white/filled/end{
	dir = 4
	},
/turf/open/pool,
/area/hilbertshotel)
"fb" = (
/obj/structure/table/wood,
/obj/item/pizzabox/margherita{
	pixel_y = 11
	},
/obj/effect/turf_decal/siding/wood{
	dir = 4
	},
/turf/open/floor/wood,
/area/hilbertshotel)
"fo" = (
/obj/effect/turf_decal/siding/wood{
	dir = 6
	},
/obj/structure/reagent_dispensers/keg/aphro/strong,
/obj/machinery/light{
	dir = 4
	},
/turf/open/floor/carpet/royalblue,
/area/hilbertshotel)
"fy" = (
/obj/effect/turf_decal/siding/wood/corner{
	dir = 4
	},
/turf/open/floor/carpet/royalblue,
/area/hilbertshotel)
"fG" = (
/obj/machinery/light{
	dir = 1
	},
/turf/open/floor/plasteel/white,
/area/hilbertshotel)
"fH" = (
/obj/effect/turf_decal/siding/wood/corner{
	dir = 8
	},
/turf/open/floor/carpet/royalblue,
/area/hilbertshotel)
"fW" = (
/obj/structure/bed,
/turf/open/floor/plasteel/white,
/area/hilbertshotel)
"gP" = (
/obj/structure/table/glass,
/obj/structure/bedsheetbin/towel,
/turf/open/floor/plasteel/white,
/area/hilbertshotel)
"gS" = (
/obj/machinery/vending/games{
	shut_up = 1
	},
/obj/effect/turf_decal/siding/wood{
	dir = 1
	},
/turf/open/floor/carpet/royalblue,
/area/hilbertshotel)
"gV" = (
/obj/effect/turf_decal/siding/wood{
	dir = 1
	},
/obj/machinery/light_switch/directional/north,
/turf/open/floor/carpet/royalblue,
/area/hilbertshotel)
"hw" = (
/turf/open/floor/wood/wood_tiled,
/area/hilbertshotel)
"hJ" = (
/turf/open/floor/wood,
/area/hilbertshotel)
"ix" = (
/obj/effect/turf_decal/siding/wood{
	dir = 8
	},
/obj/machinery/light{
	dir = 8;
	light_color = "#e8eaff"
	},
/turf/open/floor/carpet/royalblue,
/area/hilbertshotel)
"iJ" = (
/obj/effect/turf_decal/siding/wood{
	dir = 10
	},
/obj/structure/rack,
/turf/open/floor/carpet/royalblue,
/area/hilbertshotel)
"jr" = (
/obj/structure/sign/poster/contraband/random{
	pixel_x = -31
	},
/turf/open/floor/wood,
/area/hilbertshotel)
"jP" = (
/obj/structure/window/reinforced/tinted/frosted{
	dir = 1
	},
/obj/structure/chair/pew/right{
	dir = 4
	},
/turf/open/floor/wood/wood_tiled,
/area/hilbertshotel)
"jX" = (
/obj/structure/mineral_door/paperframe{
	name = "Changing Room";
	dir = 4
	},
/turf/open/floor/plasteel/white,
/area/hilbertshotel)
"kd" = (
/obj/structure/pool/Rboard,
/turf/open/floor/plasteel/white,
/area/hilbertshotel)
"ki" = (
/obj/structure/lattice,
/turf/open/space/bluespace,
/area/hilbertshotel)
"ly" = (
/obj/structure/closet/crate/wooden,
/obj/item/stack/sheet/mineral/wood/fifty,
/obj/item/lighter/gold,
/obj/item/wrench,
/turf/open/floor/carpet/red,
/area/hilbertshotel)
"mc" = (
/obj/machinery/pool/controller,
/obj/structure/railing{
	dir = 8
	},
/obj/machinery/light{
	dir = 4;
	light_color = "#c1caff"
	},
/turf/open/floor/plasteel/white,
/area/hilbertshotel)
"ne" = (
/obj/effect/turf_decal/siding/wood{
	dir = 9
	},
/turf/open/floor/carpet/royalblue,
/area/hilbertshotel)
"nJ" = (
/obj/machinery/door/window/southright{
	dir = 1
	},
/turf/open/floor/wood/wood_tiled,
/area/hilbertshotel)
"oz" = (
/obj/structure/railing{
	dir = 8
	},
/obj/machinery/pool/filter{
	pixel_y = -17
	},
/obj/structure/railing,
/turf/open/floor/plasteel/white,
/area/hilbertshotel)
"oR" = (
/obj/structure/closet/secure_closet/personal,
/obj/structure/window/reinforced/tinted/frosted{
	dir = 8
	},
/turf/open/floor/wood,
/area/hilbertshotel)
"pw" = (
/obj/structure/mineral_door/paperframe{
	name = "Changing Room";
	dir = 8
	},
/turf/open/floor/wood,
/area/hilbertshotel)
"pE" = (
/obj/effect/turf_decal/siding/wood{
	dir = 4
	},
/obj/structure/sign/painting/library{
	pixel_x = 32
	},
/turf/open/floor/carpet/royalblue,
/area/hilbertshotel)
"qi" = (
/obj/machinery/light/floor{
	bulb_colour = "F27D0C"
	},
/turf/open/floor/wood/wood_tiled,
/area/hilbertshotel)
"qm" = (
/obj/structure/table/wood,
/obj/item/storage/fancy/heart_box,
/obj/item/paper/fluff/hilbertshotel/welcomeletter,
/turf/open/floor/wood,
/area/hilbertshotel)
"qv" = (
/obj/structure/chair/pew/right{
	dir = 8
	},
/turf/open/floor/wood/wood_tiled,
/area/hilbertshotel)
"rb" = (
/obj/effect/turf_decal/trimline/white/filled/line{
	dir = 8
	},
/turf/open/pool,
/area/hilbertshotel)
"rX" = (
/obj/structure/mineral_door/paperframe{
	name = "Changing Room";
	dir = 8
	},
/turf/open/floor/plasteel/white,
/area/hilbertshotel)
"tB" = (
/obj/machinery/light,
/turf/open/floor/wood,
/area/hilbertshotel)
"tF" = (
/obj/machinery/vending/boozeomat{
	onstation = 0;
	shut_up = 1
	},
/obj/effect/turf_decal/siding/wood{
	dir = 1
	},
/turf/open/floor/carpet/royalblue,
/area/hilbertshotel)
"tS" = (
/obj/structure/closet/athletic_mixed,
/obj/structure/window/reinforced/tinted/frosted{
	dir = 4
	},
/obj/structure/window/reinforced/tinted/frosted{
	dir = 8
	},
/turf/open/floor/wood,
/area/hilbertshotel)
"tX" = (
/obj/structure/closet/crate/wooden,
/obj/effect/turf_decal/siding/wood,
/obj/machinery/light,
/obj/item/clothing/shoes/sandal,
/obj/item/clothing/shoes/sandal,
/obj/item/clothing/shoes/sandal,
/obj/item/clothing/shoes/sandal,
/obj/item/clothing/shoes/sandal,
/obj/item/clothing/shoes/sandal,
/obj/item/clothing/shoes/sandal,
/turf/open/floor/carpet/royalblue,
/area/hilbertshotel)
"ut" = (
/obj/effect/turf_decal/siding/wood{
	dir = 4
	},
/obj/machinery/light_switch/directional/east,
/turf/open/floor/carpet/royalblue,
/area/hilbertshotel)
"uG" = (
/obj/effect/turf_decal/siding/wood{
	dir = 4
	},
/turf/open/floor/wood,
/area/hilbertshotel)
"vL" = (
/obj/effect/turf_decal/siding/wood{
	dir = 1
	},
/turf/open/floor/carpet/royalblue,
/area/hilbertshotel)
"vN" = (
/obj/structure/pool/ladder{
	dir = 8;
	pixel_x = 4
	},
/obj/effect/turf_decal/trimline/white/filled/line{
	dir = 4
	},
/turf/open/pool,
/area/hilbertshotel)
"wy" = (
/obj/effect/turf_decal/siding/wood{
	dir = 4
	},
/obj/machinery/light{
	dir = 4
	},
/turf/open/floor/carpet/royalblue,
/area/hilbertshotel)
"wD" = (
/obj/structure/closet/cabinet,
/obj/effect/turf_decal/siding/wood{
	dir = 4
	},
/turf/open/floor/wood,
/area/hilbertshotel)
"xp" = (
/obj/effect/turf_decal/trimline/white/filled/line{
	dir = 9
	},
/turf/open/pool,
/area/hilbertshotel)
"xC" = (
/obj/effect/turf_decal/siding/wood{
	dir = 8
	},
/turf/open/floor/carpet/royalblue,
/area/hilbertshotel)
"xD" = (
/obj/effect/turf_decal/siding/wood,
/obj/structure/sign/painting/library{
	pixel_y = -32
	},
/turf/open/floor/carpet/royalblue,
/area/hilbertshotel)
"xU" = (
/obj/effect/turf_decal/siding/wood{
	dir = 8
	},
/obj/machinery/light_switch/directional/west,
/turf/open/floor/carpet/royalblue,
/area/hilbertshotel)
"zw" = (
/obj/effect/turf_decal/siding/wood{
	dir = 9
	},
/obj/item/kirbyplants/random,
/turf/open/floor/carpet/royalblue,
/area/hilbertshotel)
"zJ" = (
/turf/open/floor/plasteel/white,
/area/hilbertshotel)
"Aq" = (
/obj/structure/chair/pew/left{
	dir = 4
	},
/turf/open/floor/wood/wood_tiled,
/area/hilbertshotel)
"Au" = (
/obj/effect/turf_decal/siding/wood{
	dir = 6
	},
/turf/open/floor/carpet/royalblue,
/area/hilbertshotel)
"BQ" = (
/obj/effect/turf_decal/siding/wood{
	dir = 10
	},
/obj/machinery/vending/kink{
	onstation = 0;
	shut_up = 1
	},
/turf/open/floor/carpet/royalblue,
/area/hilbertshotel)
"CG" = (
/obj/effect/turf_decal/trimline/white/filled/line{
	dir = 4
	},
/obj/structure/pool/Lboard,
/turf/open/pool,
/area/hilbertshotel)
"CU" = (
/obj/effect/turf_decal/trimline/white/filled/line{
	dir = 8
	},
/obj/machinery/light{
	dir = 8;
	light_color = "#e8eaff"
	},
/turf/open/pool,
/area/hilbertshotel)
"CY" = (
/obj/machinery/light_switch/directional/east,
/obj/machinery/vending/kink,
/turf/open/floor/wood,
/area/hilbertshotel)
"CZ" = (
/obj/structure/fireplace{
	pixel_x = 0
	},
/turf/open/floor/carpet/red,
/area/hilbertshotel)
"Dt" = (
/obj/structure/chair/pew{
	dir = 4
	},
/turf/open/floor/wood/wood_tiled,
/area/hilbertshotel)
"DO" = (
/obj/structure/table,
/obj/machinery/light{
	dir = 4;
	light_color = "#c1caff"
	},
/turf/open/floor/plasteel/white,
/area/hilbertshotel)
"EW" = (
/obj/structure/window/reinforced/tinted/frosted{
	dir = 1
	},
/obj/structure/chair/pew/left{
	dir = 8
	},
/turf/open/floor/wood/wood_tiled,
/area/hilbertshotel)
"FQ" = (
/turf/closed/wall/mineral/wood,
/area/hilbertshotel)
"Gf" = (
/obj/machinery/pool/drain,
/turf/open/pool,
/area/hilbertshotel)
"Gm" = (
/obj/machinery/shower{
	pixel_y = 16
	},
/turf/open/floor/plasteel/white,
/area/hilbertshotel)
"Gs" = (
/obj/effect/turf_decal/trimline/white/filled/line{
	dir = 10
	},
/turf/open/pool,
/area/hilbertshotel)
"Gw" = (
/obj/effect/turf_decal/trimline/white/filled/line{
	dir = 4
	},
/turf/open/pool,
/area/hilbertshotel)
"GJ" = (
/turf/closed/indestructible/hoteldoor{
	icon_state = "door_closed";
	icon = 'icons/obj/doors/puzzledoor/default.dmi'
	},
/area/hilbertshotel)
"HB" = (
/obj/machinery/smartfridge/drinks,
/turf/closed/indestructible/wood,
/area/hilbertshotel)
"HN" = (
/obj/structure/table/glass,
/obj/machinery/light{
	dir = 4;
	light_color = "#c1caff"
	},
/turf/open/floor/plasteel/white,
/area/hilbertshotel)
"Kq" = (
/obj/effect/turf_decal/trimline/white/filled/line,
/obj/effect/turf_decal/trimline/white/filled/corner{
	dir = 4
	},
/turf/open/pool,
/area/hilbertshotel)
"Kt" = (
/obj/structure/falsewall/wood,
/turf/open/floor/carpet/royalblue,
/area/hilbertshotel)
"Kz" = (
/obj/structure/rack,
/obj/item/toy/poolnoodle/blue,
/obj/item/toy/poolnoodle/blue,
/obj/item/toy/poolnoodle/blue,
/turf/open/floor/wood,
/area/hilbertshotel)
"KL" = (
/obj/structure/closet/secure_closet/personal,
/obj/structure/window/reinforced/tinted/frosted{
	dir = 4
	},
/obj/structure/window/reinforced/tinted/frosted{
	dir = 8
	},
/turf/open/floor/wood,
/area/hilbertshotel)
"LP" = (
/obj/machinery/vending/cigarette{
	shut_up = 1
	},
/obj/effect/turf_decal/siding/wood{
	dir = 1
	},
/turf/open/floor/carpet/royalblue,
/area/hilbertshotel)
"Ml" = (
/obj/structure/sign/poster/contraband/random{
	pixel_x = 29
	},
/obj/structure/bed/double,
/obj/item/bedsheet/random/double,
/turf/open/floor/carpet/red,
/area/hilbertshotel)
"MT" = (
/obj/machinery/jukebox{
	req_one_access = null;
	area_limited = 1
	},
/turf/open/floor/carpet/red,
/area/hilbertshotel)
"NC" = (
/obj/structure/table/wood,
/obj/item/flashlight/lamp/green{
	pixel_x = 5;
	pixel_y = 3
	},
/turf/open/floor/carpet/red,
/area/hilbertshotel)
"ND" = (
/obj/effect/turf_decal/siding/wood/corner{
	dir = 1
	},
/turf/open/floor/carpet/royalblue,
/area/hilbertshotel)
"NG" = (
/obj/structure/window/reinforced/tinted/frosted{
	dir = 1
	},
/turf/open/floor/wood/wood_tiled,
/area/hilbertshotel)
"Op" = (
/obj/structure/closet/crate/bin{
	pixel_x = 9
	},
/obj/effect/turf_decal/siding/wood{
	dir = 1
	},
/turf/open/floor/carpet/royalblue,
/area/hilbertshotel)
"OE" = (
/turf/closed/indestructible/wood,
/area/hilbertshotel)
"OQ" = (
/obj/effect/turf_decal/trimline/white/filled/line{
	dir = 8
	},
/obj/machinery/shower{
	desc = "Despite their age, they seem clean and capable of providing hot water just as well as their modern counterparts. Hopefully Nanotrasen cleaned the water pipes this well...";
	dir = 4
	},
/turf/open/pool,
/area/hilbertshotel)
"OW" = (
/obj/effect/turf_decal/siding/wood{
	dir = 5
	},
/obj/structure/closet/crate/bin{
	pixel_x = -2
	},
/turf/open/floor/carpet/royalblue,
/area/hilbertshotel)
"OY" = (
/turf/open/pool,
/area/hilbertshotel)
"Ph" = (
/obj/machinery/vending/dinnerware{
	contraband = list(/obj/item/kitchen/rollingpin=2,/obj/item/kitchen/knife/butcher=2,/obj/item/reagent_containers/food/condiment/flour=4);
	shut_up = 1
	},
/obj/effect/turf_decal/siding/wood{
	dir = 5
	},
/turf/open/floor/carpet/royalblue,
/area/hilbertshotel)
"Pn" = (
/obj/effect/turf_decal/siding/wood{
	dir = 4
	},
/turf/open/floor/carpet/royalblue,
/area/hilbertshotel)
"PD" = (
/turf/open/floor/carpet/red,
/area/hilbertshotel)
"QM" = (
/obj/effect/turf_decal/siding/wood/corner,
/turf/open/floor/carpet/royalblue,
/area/hilbertshotel)
"QS" = (
/obj/structure/railing{
	dir = 8
	},
/obj/structure/table,
/obj/structure/bedsheetbin/towel,
/turf/open/floor/plasteel/white,
/area/hilbertshotel)
"Rt" = (
/obj/structure/bookcase/random,
/turf/open/floor/wood,
/area/hilbertshotel)
"Rz" = (
/obj/effect/turf_decal/trimline/white/filled/line,
/turf/open/pool,
/area/hilbertshotel)
"RY" = (
/obj/structure/railing{
	dir = 8
	},
/turf/open/floor/plasteel/white,
/area/hilbertshotel)
"Si" = (
/obj/machinery/telecomms/relay/preset/auto,
/turf/open/floor/catwalk_floor,
/area/hilbertshotel)
"Sv" = (
/obj/effect/turf_decal/trimline/white/filled/line{
	dir = 1
	},
/turf/open/pool,
/area/hilbertshotel)
"Sx" = (
/obj/structure/sauna_oven,
/turf/open/floor/wood/wood_tiled,
/area/hilbertshotel)
"Tp" = (
/obj/structure/reagent_dispensers/watertank,
/turf/open/floor/plasteel/white,
/area/hilbertshotel)
"TH" = (
/obj/structure/mineral_door/paperframe{
	name = "Changing Room";
	dir = 4
	},
/turf/open/floor/wood,
/area/hilbertshotel)
"Ur" = (
/obj/structure/closet/athletic_mixed,
/obj/structure/window/reinforced/tinted/frosted{
	dir = 4
	},
/turf/open/floor/wood,
/area/hilbertshotel)
"UJ" = (
/obj/structure/closet/crate/wooden,
/obj/item/stack/sheet/mineral/wood/fifty,
/obj/item/reagent_containers/glass/bucket{
	pixel_y = 7
	},
/turf/open/floor/plasteel/white,
/area/hilbertshotel)
"UR" = (
/obj/effect/turf_decal/siding/wood{
	dir = 1
	},
/obj/item/kirbyplants/random,
/turf/open/floor/carpet/royalblue,
/area/hilbertshotel)
"Vk" = (
/obj/structure/table/bronze,
/turf/open/floor/wood/wood_tiled,
/area/hilbertshotel)
"Wj" = (
/obj/structure/chair/pew{
	dir = 8
	},
/turf/open/floor/wood/wood_tiled,
/area/hilbertshotel)
"WQ" = (
/obj/machinery/pool/drain,
/turf/open/floor/plasteel/white,
/area/hilbertshotel)
"XH" = (
/obj/effect/turf_decal/siding/wood,
/obj/machinery/light,
/turf/open/floor/carpet/royalblue,
/area/hilbertshotel)
"Ym" = (
/obj/effect/turf_decal/trimline/white/filled/line{
	dir = 5
	},
/turf/open/pool,
/area/hilbertshotel)
"Zm" = (
/obj/effect/turf_decal/siding/wood,
/turf/open/floor/carpet/royalblue,
/area/hilbertshotel)

(1,1,1) = {"
OE
OE
OE
OE
OE
GJ
OE
OE
OE
OE
OE
HB
OE
OE
OE
OE
"}
(2,1,1) = {"
OE
Ur
jr
Kz
FQ
ne
iJ
FQ
xp
CU
OQ
rb
OQ
CU
Gs
OE
"}
(3,1,1) = {"
OE
tS
hJ
hJ
FQ
gV
Zm
FQ
Sv
OY
OY
Gf
OY
OY
Rz
OE
"}
(4,1,1) = {"
OE
KL
hJ
tB
FQ
vL
tX
FQ
Ym
CG
vN
Gw
Gw
Gw
Kq
OE
"}
(5,1,1) = {"
OE
KL
hJ
hJ
FQ
vL
Zm
FQ
QS
kd
zJ
RY
RY
oz
dm
OE
"}
(6,1,1) = {"
OE
oR
hJ
CY
FQ
vL
Zm
FQ
DO
zJ
fW
HN
fW
zJ
mc
OE
"}
(7,1,1) = {"
OE
FQ
pw
FQ
FQ
vL
xD
FQ
FQ
rX
FQ
FQ
FQ
FQ
FQ
OE
"}
(8,1,1) = {"
OE
zw
xC
xC
ix
ND
fH
xC
xU
xC
xC
bd
xC
Kt
BQ
OE
"}
(9,1,1) = {"
OE
OW
Pn
pE
Pn
fy
QM
wy
ut
Pn
Pn
wy
Pn
Kt
fo
OE
"}
(10,1,1) = {"
OE
FQ
TH
FQ
FQ
UR
Zm
FQ
FQ
jX
FQ
FQ
FQ
FQ
OE
OE
"}
(11,1,1) = {"
OE
Rt
hJ
qm
FQ
Op
Zm
FQ
zJ
zJ
zJ
jP
Dt
Aq
OE
Si
"}
(12,1,1) = {"
OE
wD
uG
fb
FQ
LP
Zm
FQ
Gm
zJ
zJ
NG
hw
Vk
OE
ki
"}
(13,1,1) = {"
OE
CZ
PD
ly
FQ
gS
XH
FQ
fG
WQ
zJ
nJ
qi
Sx
OE
ki
"}
(14,1,1) = {"
OE
PD
PD
MT
FQ
tF
Zm
FQ
Gm
zJ
zJ
NG
hw
Vk
OE
ki
"}
(15,1,1) = {"
OE
aN
Ml
NC
FQ
Ph
Au
FQ
gP
UJ
Tp
EW
Wj
qv
OE
ki
"}
(16,1,1) = {"
OE
OE
OE
OE
OE
OE
OE
OE
OE
OE
OE
OE
OE
OE
OE
OE
"}
