//MAP CONVERTED BY dmm2tgm.py THIS HEADER COMMENT PREVENTS RECONVERSION, DO NOT REMOVE
"af" = (
/turf/open/floor/wood/wood_tiled,
/area/hilbertshotel)
"cK" = (
/turf/open/floor/carpet/black,
/area/hilbertshotel)
"dy" = (
/obj/structure/table/wood/fancy/royalblack,
/turf/open/floor/wood/wood_tiled,
/area/hilbertshotel)
"dR" = (
/obj/structure/chair/stool/bar,
/obj/effect/turf_decal/siding/wood{
	dir = 1
	},
/turf/open/floor/wood/wood_tiled,
/area/hilbertshotel)
"ee" = (
/turf/open/floor/carpet/royalblack,
/area/hilbertshotel)
"eG" = (
/obj/structure/table/wood/poker,
/obj/structure/table/wood/poker,
/obj/item/toy/cards/deck,
/obj/machinery/atmospherics/pipe/simple/supply/hidden{
	dir = 1
	},
/turf/open/floor/carpet/royalblack,
/area/hilbertshotel)
"fo" = (
/obj/machinery/vending/boozeomat{
	shut_up = 1
	},
/turf/open/floor/wood/wood_tiled,
/area/hilbertshotel)
"hi" = (
/obj/structure/table/wood/poker,
/turf/open/floor/carpet/royalblack,
/area/hilbertshotel)
"jj" = (
/obj/machinery/atmospherics/components/unary/tank/air{
	dir = 8
	},
/turf/open/floor/plating/airless,
/area/hilbertshotel)
"kr" = (
/obj/structure/chair/stool/bar{
	dir = 1
	},
/obj/effect/turf_decal/siding/wood,
/turf/open/floor/carpet/royalblack,
/area/hilbertshotel)
"kB" = (
/obj/structure/table/wood/poker,
/obj/machinery/atmospherics/pipe/simple/scrubbers/hidden{
	piping_layer = 3;
	pixel_x = 5;
	pixel_y = 5
	},
/turf/open/floor/carpet/royalblack,
/area/hilbertshotel)
"kC" = (
/obj/structure/table/wood,
/obj/machinery/light{
	dir = 4
	},
/obj/structure/sign/poster/contraband/random{
	pixel_x = 32
	},
/turf/open/floor/carpet/royalblack,
/area/hilbertshotel)
"kQ" = (
/turf/closed/indestructible/hoteldoor{
	icon_state = "door_closed";
	icon = 'icons/obj/doors/puzzledoor/default.dmi'
	},
/area/hilbertshotel)
"li" = (
/obj/structure/table/wood,
/obj/item/reagent_containers/food/drinks/shaker{
	pixel_x = 1;
	pixel_y = 13
	},
/obj/item/reagent_containers/food/drinks/shaker{
	pixel_x = -9
	},
/obj/item/reagent_containers/food/drinks/drinkingglass,
/obj/item/reagent_containers/food/drinks/drinkingglass,
/obj/item/reagent_containers/food/drinks/drinkingglass,
/obj/item/reagent_containers/food/drinks/drinkingglass,
/obj/item/reagent_containers/food/drinks/drinkingglass,
/turf/open/floor/wood/wood_tiled,
/area/hilbertshotel)
"ln" = (
/obj/machinery/atmospherics/pipe/manifold/supply/hidden{
	dir = 1
	},
/obj/machinery/meter,
/turf/open/floor/plating/airless,
/area/hilbertshotel)
"lS" = (
/obj/structure/table/wood,
/obj/machinery/chem_dispenser/drinks/fullupgrade{
	dir = 1
	},
/turf/open/floor/wood/wood_tiled,
/area/hilbertshotel)
"lT" = (
/obj/machinery/light_switch/directional/east,
/turf/open/indestructible/hoteltile,
/area/hilbertshotel)
"nj" = (
/obj/structure/chair/stool/bar{
	dir = 1
	},
/obj/effect/turf_decal/siding/wood,
/obj/machinery/atmospherics/pipe/simple/scrubbers/hidden{
	piping_layer = 3;
	pixel_x = 5;
	pixel_y = 5
	},
/turf/open/floor/carpet/royalblack,
/area/hilbertshotel)
"oH" = (
/obj/structure/table/wood,
/obj/machinery/chem_dispenser/drinks/beer/fullupgrade{
	dir = 1
	},
/turf/open/floor/wood/wood_tiled,
/area/hilbertshotel)
"pr" = (
/obj/structure/chair/stool/bar,
/turf/open/floor/carpet/royalblack,
/area/hilbertshotel)
"pv" = (
/obj/machinery/atmospherics/pipe/simple/supply/hidden{
	dir = 1
	},
/turf/closed/indestructible/wall,
/area/hilbertshotel)
"qn" = (
/obj/machinery/light{
	dir = 1
	},
/turf/open/floor/carpet/royalblack,
/area/hilbertshotel)
"qQ" = (
/obj/structure/table/wood/poker,
/obj/structure/table/wood/poker,
/obj/machinery/atmospherics/pipe/simple/scrubbers/hidden{
	piping_layer = 3;
	pixel_x = 5;
	pixel_y = 5
	},
/turf/open/floor/carpet/royalblack,
/area/hilbertshotel)
"sk" = (
/obj/machinery/atmospherics/pipe/simple/scrubbers/hidden{
	piping_layer = 3;
	pixel_x = 5;
	pixel_y = 5
	},
/turf/closed/indestructible/wall,
/area/hilbertshotel)
"sm" = (
/obj/effect/turf_decal/siding/wood,
/turf/open/floor/carpet/royalblack,
/area/hilbertshotel)
"sU" = (
/obj/structure/sink{
	pixel_y = 24
	},
/turf/open/indestructible/hoteltile,
/area/hilbertshotel)
"sY" = (
/obj/structure/table/wood,
/obj/effect/turf_decal/siding/wood{
	dir = 8
	},
/turf/open/floor/carpet/royalblack,
/area/hilbertshotel)
"te" = (
/obj/machinery/door/morgue,
/turf/open/indestructible/hoteltile,
/area/hilbertshotel)
"tx" = (
/obj/machinery/atmospherics/pipe/simple/scrubbers/hidden{
	piping_layer = 3;
	pixel_x = 5;
	pixel_y = 5
	},
/turf/open/floor/carpet/royalblack,
/area/hilbertshotel)
"ut" = (
/obj/structure/window{
	dir = 1;
	icon_state = "window"
	},
/obj/effect/turf_decal/siding/wood{
	dir = 8
	},
/obj/structure/chair/sofa/corp/right{
	color = "#DE3A3A"
	},
/turf/open/floor/carpet/royalblack,
/area/hilbertshotel)
"vU" = (
/obj/machinery/telecomms/relay/preset/auto,
/turf/open/floor/plating/airless,
/area/hilbertshotel)
"vW" = (
/obj/structure/table/wood,
/turf/open/floor/carpet/royalblack,
/area/hilbertshotel)
"wB" = (
/obj/structure/table/wood/poker,
/obj/machinery/atmospherics/pipe/simple/supply/hidden{
	dir = 1
	},
/turf/open/floor/carpet/royalblack,
/area/hilbertshotel)
"xI" = (
/obj/structure/window{
	dir = 1;
	icon_state = "window"
	},
/obj/structure/chair/sofa/corp{
	color = "#DE3A3A"
	},
/turf/open/floor/carpet/royalblack,
/area/hilbertshotel)
"yz" = (
/turf/open/floor/glass/reinforced,
/area/hilbertshotel)
"Ae" = (
/obj/structure/urinal,
/turf/closed/indestructible/wall,
/area/hilbertshotel)
"BL" = (
/obj/machinery/light{
	dir = 8
	},
/turf/open/indestructible/hoteltile,
/area/hilbertshotel)
"Ce" = (
/obj/machinery/atmospherics/components/unary/vent_scrubber/hilbertshotel/layer3{
	dir = 1
	},
/turf/open/floor/carpet/black,
/area/hilbertshotel)
"DV" = (
/obj/machinery/light{
	dir = 1
	},
/obj/structure/toilet,
/turf/open/indestructible/hoteltile,
/area/hilbertshotel)
"EI" = (
/obj/structure/chair/stool/bar,
/obj/effect/turf_decal/siding/wood{
	dir = 4
	},
/obj/effect/turf_decal/siding/wood{
	dir = 1
	},
/turf/open/floor/wood/wood_tiled,
/area/hilbertshotel)
"Fz" = (
/obj/structure/window{
	dir = 1;
	icon_state = "window"
	},
/obj/structure/chair/sofa/corp/left{
	color = "#DE3A3A"
	},
/turf/open/floor/carpet/royalblack,
/area/hilbertshotel)
"FA" = (
/obj/structure/window{
	dir = 1
	},
/obj/effect/turf_decal/siding/wood{
	dir = 8
	},
/obj/structure/chair/sofa/corp/right{
	color = "#DE3A3A"
	},
/turf/open/floor/carpet/royalblack,
/area/hilbertshotel)
"GV" = (
/turf/open/indestructible/hoteltile,
/area/hilbertshotel)
"Hs" = (
/obj/structure/window,
/obj/structure/chair/sofa/corp/left{
	color = "#DE3A3A";
	dir = 1
	},
/obj/effect/turf_decal/siding/wood{
	dir = 8
	},
/turf/open/floor/carpet/royalblack,
/area/hilbertshotel)
"Hy" = (
/obj/structure/window,
/obj/structure/chair/sofa/corp/right{
	color = "#DE3A3A";
	dir = 1
	},
/turf/open/floor/carpet/royalblack,
/area/hilbertshotel)
"Ik" = (
/obj/structure/window{
	dir = 1
	},
/obj/structure/chair/sofa/corp{
	color = "#DE3A3A"
	},
/turf/open/floor/carpet/royalblack,
/area/hilbertshotel)
"Ji" = (
/obj/machinery/jukebox/disco{
	anchored = 1;
	req_one_access = null;
	area_limited = 1
	},
/turf/open/floor/carpet/black,
/area/hilbertshotel)
"Jy" = (
/obj/machinery/atmospherics/components/unary/outlet_injector/hilbertshotel/layer3,
/turf/open/floor/plating/airless,
/area/hilbertshotel)
"LE" = (
/obj/structure/chair/stool/bar{
	dir = 1
	},
/obj/effect/turf_decal/siding/wood,
/obj/machinery/atmospherics/pipe/simple/supply/hidden{
	dir = 1
	},
/turf/open/floor/carpet/royalblack,
/area/hilbertshotel)
"Mk" = (
/obj/machinery/atmospherics/pipe/simple/supply/hidden{
	dir = 1
	},
/turf/open/floor/carpet/royalblack,
/area/hilbertshotel)
"Mr" = (
/obj/machinery/light{
	dir = 1
	},
/obj/machinery/vending/games{
	shut_up = 1
	},
/turf/open/floor/carpet/black,
/area/hilbertshotel)
"Mz" = (
/obj/structure/window{
	dir = 1
	},
/obj/structure/chair/sofa/corp/left{
	color = "#DE3A3A"
	},
/turf/open/floor/carpet/royalblack,
/area/hilbertshotel)
"OA" = (
/obj/structure/chair/sofa/corp/right{
	color = "#DE3A3A";
	dir = 1
	},
/turf/open/floor/carpet/royalblack,
/area/hilbertshotel)
"Pz" = (
/obj/structure/sink/kitchen{
	dir = 4;
	pixel_x = -14
	},
/obj/machinery/light_switch/directional/west,
/turf/open/floor/wood/wood_tiled,
/area/hilbertshotel)
"PJ" = (
/obj/structure/window,
/obj/structure/chair/sofa/corp{
	color = "#DE3A3A";
	dir = 1
	},
/turf/open/floor/carpet/royalblack,
/area/hilbertshotel)
"QE" = (
/obj/effect/turf_decal/siding/wood{
	dir = 4
	},
/obj/machinery/door/window/survival_pod{
	dir = 4
	},
/obj/machinery/light,
/turf/open/floor/wood/wood_tiled,
/area/hilbertshotel)
"RL" = (
/obj/machinery/atmospherics/components/unary/tank/air{
	dir = 4
	},
/turf/open/floor/plating/airless,
/area/hilbertshotel)
"SW" = (
/obj/structure/sign/poster/contraband/random,
/turf/closed/indestructible/wall,
/area/hilbertshotel)
"Tk" = (
/obj/structure/table,
/obj/structure/bedsheetbin,
/turf/open/indestructible/hoteltile,
/area/hilbertshotel)
"Tx" = (
/obj/structure/chair/sofa/corp{
	color = "#DE3A3A";
	dir = 1
	},
/turf/open/floor/carpet/royalblack,
/area/hilbertshotel)
"TA" = (
/obj/structure/table/wood/fancy/royalblack,
/obj/machinery/light{
	dir = 8
	},
/turf/open/floor/wood/wood_tiled,
/area/hilbertshotel)
"UR" = (
/obj/structure/table/wood/fancy/royalblack,
/obj/effect/turf_decal/siding/wood{
	dir = 4
	},
/obj/structure/window/reinforced/survival_pod{
	dir = 4
	},
/turf/open/floor/wood/wood_tiled,
/area/hilbertshotel)
"We" = (
/obj/machinery/vending/snack/orange{
	shut_up = 1
	},
/obj/structure/sign/poster/contraband/random{
	pixel_x = 32
	},
/turf/open/floor/carpet/black,
/area/hilbertshotel)
"Wg" = (
/obj/machinery/light{
	dir = 8
	},
/turf/open/floor/carpet/black,
/area/hilbertshotel)
"WO" = (
/obj/structure/table,
/turf/open/indestructible/hoteltile,
/area/hilbertshotel)
"Xq" = (
/obj/machinery/atmospherics/components/unary/vent_pump/hilbertshotel{
	dir = 1
	},
/turf/open/floor/carpet/black,
/area/hilbertshotel)
"Xr" = (
/turf/open/space/bluespace,
/area/hilbertshotel)
"Zn" = (
/obj/structure/chair/sofa/corp/left{
	color = "#DE3A3A";
	dir = 1
	},
/obj/effect/turf_decal/siding/wood{
	dir = 8
	},
/turf/open/floor/carpet/royalblack,
/area/hilbertshotel)
"ZE" = (
/turf/closed/indestructible/wall,
/area/hilbertshotel)

(1,1,1) = {"
Xr
Xr
Xr
Xr
Xr
Xr
Xr
Xr
Xr
Xr
Xr
Xr
Xr
Xr
Xr
Xr
"}
(2,1,1) = {"
Xr
Xr
ZE
ZE
ZE
ZE
ZE
ZE
kQ
ZE
ZE
ZE
ZE
ZE
ZE
Xr
"}
(3,1,1) = {"
Xr
vU
ZE
ee
ee
ee
sm
Wg
cK
cK
dR
TA
Pz
li
ZE
Xr
"}
(4,1,1) = {"
Xr
Jy
sk
tx
kB
qQ
nj
Ce
yz
cK
dR
dy
af
lS
ZE
Xr
"}
(5,1,1) = {"
Xr
RL
SW
qn
pr
hi
kr
cK
yz
cK
dR
dy
af
oH
ZE
Xr
"}
(6,1,1) = {"
Xr
ln
pv
Mk
wB
eG
LE
Xq
yz
cK
dR
dy
af
fo
ZE
Xr
"}
(7,1,1) = {"
Xr
jj
ZE
ee
ee
ee
sm
cK
yz
cK
dR
dy
af
af
ZE
Xr
"}
(8,1,1) = {"
Xr
Xr
ZE
Ae
ZE
ZE
ZE
Ji
yz
cK
EI
UR
UR
QE
ZE
Xr
"}
(9,1,1) = {"
Xr
Xr
ZE
sU
BL
GV
te
cK
yz
cK
cK
cK
cK
cK
ZE
Xr
"}
(10,1,1) = {"
Xr
Xr
ZE
sU
lT
GV
ZE
Mr
yz
yz
yz
yz
yz
cK
ZE
Xr
"}
(11,1,1) = {"
Xr
Xr
ZE
Ae
ZE
GV
ZE
We
cK
cK
cK
cK
cK
cK
ZE
Xr
"}
(12,1,1) = {"
Xr
Xr
ZE
DV
te
GV
ZE
ZE
ut
sY
Hs
FA
sY
Zn
ZE
Xr
"}
(13,1,1) = {"
Xr
Xr
ZE
ZE
ZE
GV
Tk
ZE
xI
vW
PJ
Ik
vW
Tx
ZE
Xr
"}
(14,1,1) = {"
Xr
Xr
ZE
DV
te
GV
WO
ZE
Fz
kC
Hy
Mz
kC
OA
ZE
Xr
"}
(15,1,1) = {"
Xr
Xr
ZE
ZE
ZE
ZE
ZE
ZE
ZE
ZE
ZE
ZE
ZE
ZE
ZE
Xr
"}
(16,1,1) = {"
Xr
Xr
Xr
Xr
Xr
Xr
Xr
Xr
Xr
Xr
Xr
Xr
Xr
Xr
Xr
Xr
"}
